Topic 1,Topic 2,Topic 3,Topic 4,Topic 5,Topic 6,Topic 7,Topic 8,Topic 9,Topic 10,Topic 11,Topic 12,Topic 13,Topic 14,Topic 15,Topic 16,Topic 17,Topic 18,Topic 19,Topic 20,Topic 21,Topic 22,Topic 23,Topic 24,Topic 25,Topic 26
ENSG00000167107,ENSG00000161203,ENSG00000160124,ENSG00000197249,ENSG00000130635,ENSG00000139629,ENSG00000129009,ENSG00000105854,ENSG00000213722,ENSG00000141756,ENSG00000157613,ENSG00000101443,ENSG00000160180,ENSG00000033327,ENSG00000114770,ENSG00000092964,ENSG00000115641,ENSG00000269981,ENSG00000038427,ENSG00000171860,ENSG00000198517,ENSG00000170345,ENSG00000041982,ENSG00000110876,ENSG00000168209,ENSG00000058063
ENSG00000130414,ENSG00000187840,ENSG00000174348,ENSG00000213903,ENSG00000141424,ENSG00000134986,ENSG00000146674,ENSG00000006327,ENSG00000105270,ENSG00000114023,ENSG00000139926,ENSG00000008517,ENSG00000138623,ENSG00000154217,ENSG00000108821,ENSG00000176153,ENSG00000166033,ENSG00000185619,ENSG00000203724,ENSG00000136235,ENSG00000189171,ENSG00000066336,ENSG00000109062,ENSG00000255198,ENSG00000168765,ENSG00000175287
ENSG00000115414,ENSG00000157992,ENSG00000152583,ENSG00000185033,ENSG00000117632,ENSG00000164442,ENSG00000198142,ENSG00000112378,ENSG00000161203,ENSG00000236552,ENSG00000185499,ENSG00000066336,ENSG00000137970,ENSG00000116791,ENSG00000088836,ENSG00000011422,ENSG00000172236,ENSG00000139329,ENSG00000149269,ENSG00000185633,ENSG00000129009,ENSG00000206341,ENSG00000108582,ENSG00000165949,ENSG00000162616,ENSG00000078401
ENSG00000212802,ENSG00000140526,ENSG00000142156,ENSG00000177383,ENSG00000173950,ENSG00000071242,ENSG00000080573,ENSG00000164442,ENSG00000152137,ENSG00000249915,ENSG00000181788,ENSG00000105655,ENSG00000178860,ENSG00000074416,ENSG00000179604,ENSG00000131153,ENSG00000143546,ENSG00000127399,ENSG00000102878,ENSG00000133321,ENSG00000059804,ENSG00000182551,ENSG00000109107,ENSG00000161055,ENSG00000117632,ENSG00000111671
ENSG00000242299,ENSG00000260260,ENSG00000128311,ENSG00000169715,ENSG00000167772,ENSG00000104332,ENSG00000116701,ENSG00000226950,ENSG00000023909,ENSG00000109046,ENSG00000269899,ENSG00000119514,ENSG00000085662,ENSG00000142102,ENSG00000043093,ENSG00000114346,ENSG00000235501,ENSG00000127329,ENSG00000008311,ENSG00000198189,ENSG00000104419,ENSG00000135046,ENSG00000006210,ENSG00000106333,ENSG00000198189,ENSG00000137077
ENSG00000065802,ENSG00000175193,ENSG00000111912,ENSG00000152766,ENSG00000172543,ENSG00000173599,ENSG00000179085,ENSG00000137331,ENSG00000130635,ENSG00000107159,ENSG00000175567,ENSG00000177565,ENSG00000132329,ENSG00000204642,ENSG00000189171,ENSG00000106538,ENSG00000072210,ENSG00000116741,ENSG00000060656,ENSG00000204219,ENSG00000004799,ENSG00000120129,ENSG00000244313,ENSG00000153179,ENSG00000121769,ENSG00000146674
ENSG00000169439,ENSG00000101003,ENSG00000120129,ENSG00000137876,ENSG00000109814,ENSG00000134184,ENSG00000120756,ENSG00000131979,ENSG00000104267,ENSG00000198478,ENSG00000120708,ENSG00000099284,ENSG00000172164,ENSG00000206341,ENSG00000139263,ENSG00000175567,ENSG00000146242,ENSG00000125740,ENSG00000184220,ENSG00000103811,ENSG00000131711,ENSG00000180543,ENSG00000126709,ENSG00000171476,ENSG00000096092,ENSG00000163923
ENSG00000134463,ENSG00000227507,ENSG00000141510,ENSG00000171236,ENSG00000123689,ENSG00000182871,ENSG00000092068,ENSG00000161179,ENSG00000180530,ENSG00000141232,ENSG00000123384,ENSG00000145632,ENSG00000060656,ENSG00000186517,ENSG00000100097,ENSG00000166803,ENSG00000147872,ENSG00000090339,ENSG00000200534,ENSG00000239467,ENSG00000135678,ENSG00000008517,ENSG00000135677,ENSG00000101194,ENSG00000123689,ENSG00000188015
ENSG00000183779,ENSG00000113504,ENSG00000211890,ENSG00000138166,ENSG00000177732,ENSG00000072274,ENSG00000054277,ENSG00000113569,ENSG00000188783,ENSG00000161055,ENSG00000177191,ENSG00000137936,ENSG00000139211,ENSG00000120306,ENSG00000189058,ENSG00000111110,ENSG00000129538,ENSG00000163251,ENSG00000133687,ENSG00000119138,ENSG00000206337,ENSG00000111907,ENSG00000115271,ENSG00000143819,ENSG00000142875,ENSG00000211679
ENSG00000181826,ENSG00000146731,ENSG00000204219,ENSG00000180596,ENSG00000179862,ENSG00000095970,ENSG00000129521,ENSG00000242861,ENSG00000128045,ENSG00000167797,ENSG00000118503,ENSG00000168878,ENSG00000211892,ENSG00000140526,ENSG00000137166,ENSG00000200087,ENSG00000166086,ENSG00000163406,ENSG00000075240,ENSG00000099860,ENSG00000100292,ENSG00000169490,ENSG00000118971,ENSG00000182240,ENSG00000077152,ENSG00000029153
ENSG00000174514,ENSG00000136425,ENSG00000120217,ENSG00000153714,ENSG00000237649,ENSG00000019549,ENSG00000234851,ENSG00000121864,ENSG00000095970,ENSG00000145860,ENSG00000134759,ENSG00000257017,ENSG00000091409,ENSG00000105088,ENSG00000104213,ENSG00000162738,ENSG00000214530,ENSG00000099998,ENSG00000163577,ENSG00000114857,ENSG00000102524,ENSG00000137563,ENSG00000140379,ENSG00000106089,ENSG00000115380,ENSG00000155066
ENSG00000162738,ENSG00000130513,ENSG00000143320,ENSG00000148926,ENSG00000164683,ENSG00000125968,ENSG00000122694,ENSG00000114554,ENSG00000177337,ENSG00000101447,ENSG00000182985,ENSG00000170571,ENSG00000142798,ENSG00000100504,ENSG00000142102,ENSG00000085117,ENSG00000105426,ENSG00000163141,ENSG00000176619,ENSG00000218175,ENSG00000198848,ENSG00000132329,ENSG00000115902,ENSG00000158373,ENSG00000185585,ENSG00000131378
ENSG00000149716,ENSG00000213553,ENSG00000149260,ENSG00000096092,ENSG00000245532,ENSG00000133392,ENSG00000176387,ENSG00000099953,ENSG00000182013,ENSG00000119986,ENSG00000108602,ENSG00000176920,ENSG00000196975,ENSG00000109881,ENSG00000111110,ENSG00000170801,ENSG00000105655,ENSG00000138207,ENSG00000128298,ENSG00000188820,ENSG00000145194,ENSG00000134070,ENSG00000168734,ENSG00000007944,ENSG00000138772,ENSG00000198431
ENSG00000112290,ENSG00000138795,ENSG00000238142,ENSG00000245694,ENSG00000169180,ENSG00000061656,ENSG00000139239,ENSG00000141424,ENSG00000131626,ENSG00000181744,ENSG00000187134,ENSG00000141384,ENSG00000070087,ENSG00000134759,ENSG00000163209,ENSG00000178726,ENSG00000169738,ENSG00000008853,ENSG00000229119,ENSG00000106483,ENSG00000103888,ENSG00000114744,ENSG00000162639,ENSG00000175324,ENSG00000147526,ENSG00000214485
ENSG00000137331,ENSG00000145996,ENSG00000120885,ENSG00000013588,ENSG00000128591,ENSG00000143819,ENSG00000063660,ENSG00000143382,ENSG00000162551,ENSG00000113448,ENSG00000166532,ENSG00000260549,ENSG00000163513,ENSG00000128342,ENSG00000163874,ENSG00000115641,ENSG00000145632,ENSG00000270157,ENSG00000198732,ENSG00000116016,ENSG00000197165,ENSG00000197696,ENSG00000091583,ENSG00000126368,ENSG00000234614,ENSG00000148700
ENSG00000243554,ENSG00000105063,ENSG00000071539,ENSG00000135046,ENSG00000138795,ENSG00000183298,ENSG00000127914,ENSG00000071539,ENSG00000172005,ENSG00000130222,ENSG00000166963,ENSG00000148803,ENSG00000090376,ENSG00000091986,ENSG00000204381,ENSG00000229344,ENSG00000223612,ENSG00000136379,ENSG00000099860,ENSG00000119514,ENSG00000124126,ENSG00000165507,ENSG00000202198,ENSG00000154930,ENSG00000149328,ENSG00000105971
ENSG00000176826,ENSG00000166226,ENSG00000109445,ENSG00000109814,ENSG00000139146,ENSG00000185432,ENSG00000187653,ENSG00000162496,ENSG00000160862,ENSG00000147471,ENSG00000096088,ENSG00000168917,ENSG00000110944,ENSG00000226137,ENSG00000243554,ENSG00000233476,ENSG00000179922,ENSG00000102575,ENSG00000107140,ENSG00000173207,ENSG00000197249,ENSG00000138678,ENSG00000147471,ENSG00000244405,ENSG00000135838,ENSG00000138772
ENSG00000188536,ENSG00000175505,ENSG00000099337,ENSG00000116761,ENSG00000113504,ENSG00000102524,ENSG00000106688,ENSG00000074370,ENSG00000214357,ENSG00000168899,ENSG00000023909,ENSG00000114378,ENSG00000173918,ENSG00000168743,ENSG00000246451,ENSG00000115457,ENSG00000100413,ENSG00000076641,ENSG00000177383,ENSG00000161202,ENSG00000155792,ENSG00000100342,ENSG00000114631,ENSG00000171227,ENSG00000131016,ENSG00000099958
ENSG00000120708,ENSG00000120738,ENSG00000245848,ENSG00000189171,ENSG00000198176,ENSG00000108602,ENSG00000106025,ENSG00000049540,ENSG00000260549,ENSG00000117595,ENSG00000264281,ENSG00000239246,ENSG00000074201,ENSG00000132329,ENSG00000211897,ENSG00000169515,ENSG00000178826,ENSG00000227671,ENSG00000109107,ENSG00000240065,ENSG00000242125,ENSG00000137628,ENSG00000154153,ENSG00000185963,ENSG00000196187,ENSG00000097021
ENSG00000143179,ENSG00000154553,ENSG00000142945,ENSG00000196754,ENSG00000118503,ENSG00000157456,ENSG00000179943,ENSG00000116701,ENSG00000120437,ENSG00000165949,ENSG00000186832,ENSG00000170509,ENSG00000136052,ENSG00000099958,ENSG00000013810,ENSG00000132432,ENSG00000136153,ENSG00000074527,ENSG00000173599,ENSG00000154240,ENSG00000217555,ENSG00000151332,ENSG00000152229,ENSG00000136859,ENSG00000188906,ENSG00000101457
ENSG00000128849,ENSG00000181649,ENSG00000204262,ENSG00000162692,ENSG00000125148,ENSG00000164023,ENSG00000068079,ENSG00000112144,ENSG00000166347,ENSG00000090104,ENSG00000127585,ENSG00000136048,ENSG00000166165,ENSG00000228594,ENSG00000141510,ENSG00000173706,ENSG00000171227,ENSG00000136167,ENSG00000120885,ENSG00000072163,ENSG00000170412,ENSG00000102934,ENSG00000145386,ENSG00000198682,ENSG00000160255,ENSG00000163171
