Topic 1,Topic 2,Topic 3,Topic 4,Topic 5,Topic 6,Topic 7,Topic 8,Topic 9,Topic 10,Topic 11,Topic 12,Topic 13,Topic 14,Topic 15,Topic 16,Topic 17,Topic 18,Topic 19,Topic 20,Topic 21,Topic 22,Topic 23,Topic 24,Topic 25,Topic 26,Topic 27,Topic 28,Topic 29,Topic 30,Topic 31,Topic 32,Topic 33,Topic 34,Topic 35,Topic 36,Topic 37,Topic 38,Topic 39,Topic 40,Topic 41,Topic 42,Topic 43,Topic 44,Topic 45,Topic 46,Topic 47,Topic 48,Topic 49,Topic 50
ENSG00000065802,ENSG00000146731,ENSG00000204262,ENSG00000166582,ENSG00000101443,ENSG00000134986,ENSG00000116701,ENSG00000006327,ENSG00000105270,ENSG00000249915,ENSG00000177191,ENSG00000186081,ENSG00000173918,ENSG00000132465,ENSG00000108821,ENSG00000092964,ENSG00000169738,ENSG00000004799,ENSG00000038427,ENSG00000171860,ENSG00000135678,ENSG00000206341,ENSG00000109107,ENSG00000110876,ENSG00000142875,ENSG00000058063,ENSG00000127337,ENSG00000103888,ENSG00000001084,ENSG00000163961,ENSG00000120437,ENSG00000079462,ENSG00000085662,ENSG00000167972,ENSG00000085788,ENSG00000057019,ENSG00000157992,ENSG00000229344,ENSG00000135677,ENSG00000111206,ENSG00000254709,ENSG00000144959,ENSG00000165929,ENSG00000175602,ENSG00000064115,ENSG00000124466,ENSG00000158270,ENSG00000214022,ENSG00000144959,ENSG00000182551
ENSG00000264281,ENSG00000204291,ENSG00000160124,ENSG00000180596,ENSG00000173950,ENSG00000102524,ENSG00000092068,ENSG00000242861,ENSG00000213722,ENSG00000107159,ENSG00000175567,ENSG00000170571,ENSG00000060656,ENSG00000196352,ENSG00000189171,ENSG00000131153,ENSG00000147872,ENSG00000135002,ENSG00000176619,ENSG00000185633,ENSG00000131711,ENSG00000114744,ENSG00000041982,ENSG00000244405,ENSG00000198189,ENSG00000111671,ENSG00000116285,ENSG00000131378,ENSG00000213088,ENSG00000128016,ENSG00000168615,ENSG00000135069,ENSG00000198431,ENSG00000021300,ENSG00000149328,ENSG00000108821,ENSG00000129538,ENSG00000158467,ENSG00000121039,ENSG00000163872,ENSG00000139318,ENSG00000185090,ENSG00000104419,ENSG00000183688,ENSG00000145860,ENSG00000127951,ENSG00000112773,ENSG00000162551,ENSG00000134531,ENSG00000152661
ENSG00000161243,ENSG00000175193,ENSG00000085377,ENSG00000213903,ENSG00000177732,ENSG00000146242,ENSG00000146674,ENSG00000226950,ENSG00000196549,ENSG00000236552,ENSG00000075618,ENSG00000105655,ENSG00000025708,ENSG00000168679,ENSG00000100097,ENSG00000166803,ENSG00000166033,ENSG00000152642,ENSG00000133687,ENSG00000136235,ENSG00000121552,ENSG00000250722,ENSG00000109062,ENSG00000081041,ENSG00000104368,ENSG00000162496,ENSG00000115525,ENSG00000107317,ENSG00000135929,ENSG00000106992,ENSG00000183779,ENSG00000153395,ENSG00000161281,ENSG00000169442,ENSG00000108578,ENSG00000172889,ENSG00000127603,ENSG00000131400,ENSG00000165949,ENSG00000106366,ENSG00000163251,ENSG00000121152,ENSG00000127990,ENSG00000166741,ENSG00000161055,ENSG00000124102,ENSG00000118785,ENSG00000050344,ENSG00000130707,ENSG00000196352
ENSG00000189343,ENSG00000161513,ENSG00000169469,ENSG00000177191,ENSG00000142632,ENSG00000139629,ENSG00000137801,ENSG00000141424,ENSG00000074201,ENSG00000141756,ENSG00000118503,ENSG00000149781,ENSG00000159228,ENSG00000159228,ENSG00000117525,ENSG00000233476,ENSG00000214530,ENSG00000117091,ENSG00000090006,ENSG00000119138,ENSG00000206337,ENSG00000163993,ENSG00000241794,ENSG00000005884,ENSG00000162616,ENSG00000136514,ENSG00000183696,ENSG00000130176,ENSG00000136235,ENSG00000270170,ENSG00000183049,ENSG00000136859,ENSG00000121966,ENSG00000143324,ENSG00000011465,ENSG00000168542,ENSG00000161638,ENSG00000105854,ENSG00000174106,ENSG00000092964,ENSG00000100097,ENSG00000171236,ENSG00000130222,ENSG00000120992,ENSG00000041802,ENSG00000185340,ENSG00000175040,ENSG00000120756,ENSG00000247134,ENSG00000157456
ENSG00000130414,ENSG00000157992,ENSG00000142156,ENSG00000137876,ENSG00000169180,ENSG00000104332,ENSG00000179943,ENSG00000135047,ENSG00000259943,ENSG00000068650,ENSG00000264281,ENSG00000134508,ENSG00000134802,ENSG00000065054,ENSG00000187653,ENSG00000178726,ENSG00000090382,ENSG00000025708,ENSG00000139289,ENSG00000099860,ENSG00000129009,ENSG00000175567,ENSG00000108950,ENSG00000101457,ENSG00000120885,ENSG00000155066,ENSG00000106366,ENSG00000172890,ENSG00000233429,ENSG00000139173,ENSG00000120129,ENSG00000117594,ENSG00000183087,ENSG00000114270,ENSG00000161204,ENSG00000182578,ENSG00000115419,ENSG00000116285,ENSG00000152284,ENSG00000120594,ENSG00000160883,ENSG00000006210,ENSG00000241794,ENSG00000138166,ENSG00000090339,ENSG00000169710,ENSG00000164292,ENSG00000205213,ENSG00000109107,ENSG00000123358
ENSG00000162639,ENSG00000260260,ENSG00000174640,ENSG00000213853,ENSG00000123689,ENSG00000134184,ENSG00000198142,ENSG00000074410,ENSG00000181788,ENSG00000101447,ENSG00000269899,ENSG00000090621,ENSG00000100196,ENSG00000101003,ENSG00000088836,ENSG00000173706,ENSG00000235501,ENSG00000166920,ENSG00000177383,ENSG00000239467,ENSG00000172724,ENSG00000164647,ENSG00000115271,ENSG00000188783,ENSG00000147526,ENSG00000129691,ENSG00000137486,ENSG00000163884,ENSG00000147459,ENSG00000115425,ENSG00000108582,ENSG00000112299,ENSG00000261221,ENSG00000099994,ENSG00000134020,ENSG00000038945,ENSG00000181744,ENSG00000141574,ENSG00000156471,ENSG00000114737,ENSG00000161203,ENSG00000198502,ENSG00000146729,ENSG00000162545,ENSG00000100985,ENSG00000175061,ENSG00000162616,ENSG00000241973,ENSG00000203760,ENSG00000012171
ENSG00000167107,ENSG00000167315,ENSG00000174348,ENSG00000187837,ENSG00000117632,ENSG00000105088,ENSG00000054277,ENSG00000137331,ENSG00000177337,ENSG00000109046,ENSG00000134759,ENSG00000119938,ENSG00000064989,ENSG00000109881,ENSG00000249119,ENSG00000143179,ENSG00000153885,ENSG00000240065,ENSG00000128016,ENSG00000161202,ENSG00000211679,ENSG00000108821,ENSG00000080573,ENSG00000169136,ENSG00000176153,ENSG00000166073,ENSG00000172348,ENSG00000134202,ENSG00000136997,ENSG00000053747,ENSG00000181458,ENSG00000166833,ENSG00000221978,ENSG00000235501,ENSG00000090661,ENSG00000166851,ENSG00000075651,ENSG00000060656,ENSG00000140564,ENSG00000173432,ENSG00000122852,ENSG00000131944,ENSG00000119535,ENSG00000119681,ENSG00000213853,ENSG00000174938,ENSG00000163507,ENSG00000163993,ENSG00000135547,ENSG00000134013
ENSG00000162654,ENSG00000113504,ENSG00000154734,ENSG00000205420,ENSG00000167772,ENSG00000112312,ENSG00000152583,ENSG00000163513,ENSG00000023909,ENSG00000145860,ENSG00000108106,ENSG00000164674,ENSG00000164266,ENSG00000091986,ENSG00000239569,ENSG00000170801,ENSG00000105655,ENSG00000125845,ENSG00000090924,ENSG00000188820,ENSG00000198898,ENSG00000143196,ENSG00000170345,ENSG00000155066,ENSG00000135838,ENSG00000105894,ENSG00000139289,ENSG00000099219,ENSG00000131015,ENSG00000111412,ENSG00000129538,ENSG00000002933,ENSG00000130592,ENSG00000008256,ENSG00000104140,ENSG00000101412,ENSG00000184500,ENSG00000132329,ENSG00000125148,ENSG00000157368,ENSG00000166086,ENSG00000132465,ENSG00000132465,ENSG00000170899,ENSG00000175061,ENSG00000163209,ENSG00000233493,ENSG00000171476,ENSG00000232677,ENSG00000235098
ENSG00000260000,ENSG00000187840,ENSG00000120217,ENSG00000177383,ENSG00000111261,ENSG00000019549,ENSG00000179085,ENSG00000100336,ENSG00000160862,ENSG00000114023,ENSG00000243955,ENSG00000186998,ENSG00000052795,ENSG00000086300,ENSG00000197930,ENSG00000124225,ENSG00000115641,ENSG00000203724,ENSG00000084731,ENSG00000182704,ENSG00000102524,ENSG00000163171,ENSG00000118971,ENSG00000181830,ENSG00000110876,ENSG00000072210,ENSG00000104856,ENSG00000185112,ENSG00000266714,ENSG00000163823,ENSG00000104140,ENSG00000119138,ENSG00000136167,ENSG00000203778,ENSG00000128342,ENSG00000159212,ENSG00000224769,ENSG00000179085,ENSG00000065154,ENSG00000197256,ENSG00000083937,ENSG00000112699,ENSG00000171310,ENSG00000100522,ENSG00000214022,ENSG00000106624,ENSG00000143248,ENSG00000164932,ENSG00000159640,ENSG00000187840
ENSG00000180573,ENSG00000095303,ENSG00000141510,ENSG00000197249,ENSG00000141424,ENSG00000139508,ENSG00000141741,ENSG00000161179,ENSG00000064300,ENSG00000105825,ENSG00000185338,ENSG00000141384,ENSG00000116701,ENSG00000099958,ENSG00000100003,ENSG00000137055,ENSG00000145632,ENSG00000105369,ENSG00000140525,ENSG00000112144,ENSG00000124942,ENSG00000134339,ENSG00000244313,ENSG00000187193,ENSG00000168209,ENSG00000174938,ENSG00000267523,ENSG00000164687,ENSG00000053747,ENSG00000153234,ENSG00000196154,ENSG00000137642,ENSG00000166582,ENSG00000257702,ENSG00000124772,ENSG00000227507,ENSG00000118785,ENSG00000144655,ENSG00000122861,ENSG00000004799,ENSG00000101384,ENSG00000263740,ENSG00000065320,ENSG00000110852,ENSG00000182636,ENSG00000169583,ENSG00000111445,ENSG00000125144,ENSG00000161638,ENSG00000170801
ENSG00000128849,ENSG00000172893,ENSG00000238142,ENSG00000160867,ENSG00000172543,ENSG00000196937,ENSG00000160255,ENSG00000187193,ENSG00000105427,ENSG00000119986,ENSG00000139926,ENSG00000171560,ENSG00000188508,ENSG00000125968,ENSG00000105767,ENSG00000008735,ENSG00000152137,ENSG00000254909,ENSG00000141741,ENSG00000198189,ENSG00000169442,ENSG00000166123,ENSG00000147471,ENSG00000143196,ENSG00000155465,ENSG00000097021,ENSG00000130755,ENSG00000167711,ENSG00000168040,ENSG00000140564,ENSG00000136379,ENSG00000163251,ENSG00000189171,ENSG00000078401,ENSG00000166347,ENSG00000074416,ENSG00000179833,ENSG00000166562,ENSG00000160886,ENSG00000121552,ENSG00000166741,ENSG00000173852,ENSG00000160180,ENSG00000076864,ENSG00000131771,ENSG00000064205,ENSG00000124785,ENSG00000104951,ENSG00000182118,ENSG00000104081
ENSG00000139679,ENSG00000104368,ENSG00000139350,ENSG00000096092,ENSG00000237649,ENSG00000168785,ENSG00000180340,ENSG00000112144,ENSG00000152377,ENSG00000168899,ENSG00000166592,ENSG00000026103,ENSG00000237649,ENSG00000213442,ENSG00000148803,ENSG00000085117,ENSG00000166920,ENSG00000168394,ENSG00000101194,ENSG00000186847,ENSG00000171462,ENSG00000131015,ENSG00000114115,ENSG00000202198,ENSG00000196187,ENSG00000002933,ENSG00000142798,ENSG00000179456,ENSG00000228502,ENSG00000197461,ENSG00000175265,ENSG00000162692,ENSG00000196352,ENSG00000129009,ENSG00000076382,ENSG00000226332,ENSG00000080573,ENSG00000019991,ENSG00000070501,ENSG00000136514,ENSG00000184916,ENSG00000196205,ENSG00000198794,ENSG00000235169,ENSG00000184371,ENSG00000164647,ENSG00000128274,ENSG00000106804,ENSG00000154277,ENSG00000130702
ENSG00000025708,ENSG00000169896,ENSG00000153885,ENSG00000109814,ENSG00000132819,ENSG00000158825,ENSG00000129009,ENSG00000135205,ENSG00000136518,ENSG00000117595,ENSG00000112378,ENSG00000239246,ENSG00000143110,ENSG00000101400,ENSG00000224631,ENSG00000011422,ENSG00000100413,ENSG00000115419,ENSG00000131378,ENSG00000167653,ENSG00000227507,ENSG00000197457,ENSG00000103222,ENSG00000198682,ENSG00000170190,ENSG00000180543,ENSG00000143196,ENSG00000106538,ENSG00000171045,ENSG00000096060,ENSG00000156675,ENSG00000071967,ENSG00000175899,ENSG00000074181,ENSG00000143850,ENSG00000179715,ENSG00000169442,ENSG00000128602,ENSG00000113657,ENSG00000106809,ENSG00000155792,ENSG00000130707,ENSG00000142530,ENSG00000228623,ENSG00000168734,ENSG00000128602,ENSG00000204789,ENSG00000272841,ENSG00000185963,ENSG00000095303
ENSG00000169439,ENSG00000140526,ENSG00000143248,ENSG00000140526,ENSG00000118849,ENSG00000134247,ENSG00000068079,ENSG00000213722,ENSG00000204291,ENSG00000224945,ENSG00000185745,ENSG00000033867,ENSG00000159200,ENSG00000143776,ENSG00000111110,ENSG00000168386,ENSG00000160255,ENSG00000196636,ENSG00000107140,ENSG00000168743,ENSG00000124126,ENSG00000179833,ENSG00000115902,ENSG00000126368,ENSG00000168765,ENSG00000214485,ENSG00000196975,ENSG00000152952,ENSG00000139289,ENSG00000186603,ENSG00000131400,ENSG00000133321,ENSG00000185567,ENSG00000123384,ENSG00000175567,ENSG00000106003,ENSG00000167513,ENSG00000143797,ENSG00000163975,ENSG00000130414,ENSG00000198736,ENSG00000173281,ENSG00000179094,ENSG00000204444,ENSG00000100342,ENSG00000168679,ENSG00000167711,ENSG00000198431,ENSG00000117632,ENSG00000236552
ENSG00000092607,ENSG00000105063,ENSG00000156804,ENSG00000137462,ENSG00000129009,ENSG00000175567,ENSG00000122694,ENSG00000114554,ENSG00000085514,ENSG00000167653,ENSG00000008311,ENSG00000099994,ENSG00000111445,ENSG00000222041,ENSG00000139194,ENSG00000169136,ENSG00000173559,ENSG00000004399,ENSG00000168275,ENSG00000095539,ENSG00000142156,ENSG00000221978,ENSG00000168734,ENSG00000153179,ENSG00000139679,ENSG00000128039,ENSG00000163171,ENSG00000244405,ENSG00000096060,ENSG00000115306,ENSG00000137936,ENSG00000139116,ENSG00000171476,ENSG00000101000,ENSG00000108830,ENSG00000198832,ENSG00000100097,ENSG00000165474,ENSG00000184916,ENSG00000076641,ENSG00000020633,ENSG00000107175,ENSG00000063180,ENSG00000215006,ENSG00000184436,ENSG00000255198,ENSG00000158669,ENSG00000169429,ENSG00000134463,ENSG00000181826
ENSG00000101255,ENSG00000117091,ENSG00000111912,ENSG00000155465,ENSG00000198189,ENSG00000214389,ENSG00000127951,ENSG00000100385,ENSG00000181804,ENSG00000113448,ENSG00000109814,ENSG00000183298,ENSG00000138623,ENSG00000033327,ENSG00000143320,ENSG00000162738,ENSG00000131400,ENSG00000176153,ENSG00000175084,ENSG00000213949,ENSG00000250722,ENSG00000135083,ENSG00000104998,ENSG00000116661,ENSG00000090661,ENSG00000110721,ENSG00000248485,ENSG00000125772,ENSG00000136059,ENSG00000123106,ENSG00000250722,ENSG00000147526,ENSG00000155465,ENSG00000142875,ENSG00000105810,ENSG00000120306,ENSG00000254893,ENSG00000240065,ENSG00000235109,ENSG00000138080,ENSG00000154122,ENSG00000135929,ENSG00000074181,ENSG00000114023,ENSG00000100413,ENSG00000146122,ENSG00000124466,ENSG00000173727,ENSG00000076382,ENSG00000181524
ENSG00000181826,ENSG00000164692,ENSG00000105426,ENSG00000116761,ENSG00000128591,ENSG00000164949,ENSG00000162493,ENSG00000099953,ENSG00000131626,ENSG00000203785,ENSG00000182985,ENSG00000105048,ENSG00000172164,ENSG00000140526,ENSG00000249007,ENSG00000216775,ENSG00000060558,ENSG00000145824,ENSG00000256594,ENSG00000218175,ENSG00000145194,ENSG00000084731,ENSG00000154153,ENSG00000174007,ENSG00000188906,ENSG00000188015,ENSG00000143622,ENSG00000172543,ENSG00000076258,ENSG00000118849,ENSG00000125740,ENSG00000143320,ENSG00000100918,ENSG00000137462,ENSG00000108602,ENSG00000073150,ENSG00000144810,ENSG00000167772,ENSG00000169750,ENSG00000211895,ENSG00000211895,ENSG00000083937,ENSG00000137809,ENSG00000101000,ENSG00000143882,ENSG00000132432,ENSG00000126368,ENSG00000155380,ENSG00000234797,ENSG00000101230
ENSG00000189366,ENSG00000141854,ENSG00000081277,ENSG00000132465,ENSG00000114473,ENSG00000088325,ENSG00000080573,ENSG00000113569,ENSG00000249592,ENSG00000134369,ENSG00000136114,ENSG00000185303,ENSG00000025423,ENSG00000115590,ENSG00000115641,ENSG00000115641,ENSG00000137959,ENSG00000137857,ENSG00000004776,ENSG00000163472,ENSG00000242125,ENSG00000181019,ENSG00000137266,ENSG00000172236,ENSG00000131016,ENSG00000172893,ENSG00000204556,ENSG00000095539,ENSG00000175592,ENSG00000259820,ENSG00000089692,ENSG00000198682,ENSG00000161204,ENSG00000175445,ENSG00000143369,ENSG00000174807,ENSG00000115380,ENSG00000138640,ENSG00000025708,ENSG00000257017,ENSG00000176485,ENSG00000150687,ENSG00000081181,ENSG00000138758,ENSG00000171421,ENSG00000128298,ENSG00000077235,ENSG00000148344,ENSG00000187688,ENSG00000163874
ENSG00000181392,ENSG00000131435,ENSG00000134802,ENSG00000196754,ENSG00000171045,ENSG00000213462,ENSG00000111530,ENSG00000041802,ENSG00000224769,ENSG00000135245,ENSG00000134824,ENSG00000181019,ENSG00000188257,ENSG00000108352,ENSG00000204815,ENSG00000206341,ENSG00000143013,ENSG00000166825,ENSG00000073111,ENSG00000204219,ENSG00000145824,ENSG00000166562,ENSG00000108582,ENSG00000074527,ENSG00000081181,ENSG00000047457,ENSG00000154065,ENSG00000168758,ENSG00000008441,ENSG00000198435,ENSG00000229119,ENSG00000141756,ENSG00000219928,ENSG00000143797,ENSG00000062716,ENSG00000255769,ENSG00000088836,ENSG00000128567,ENSG00000179593,ENSG00000164002,ENSG00000183688,ENSG00000163918,ENSG00000110400,ENSG00000257017,ENSG00000134755,ENSG00000182809,ENSG00000260231,ENSG00000096060,ENSG00000163918,ENSG00000179241
ENSG00000135549,ENSG00000136425,ENSG00000099337,ENSG00000162998,ENSG00000228623,ENSG00000094804,ENSG00000167600,ENSG00000133466,ENSG00000101255,ENSG00000159228,ENSG00000160326,ENSG00000185499,ENSG00000178821,ENSG00000173706,ENSG00000254682,ENSG00000176153,ENSG00000146242,ENSG00000188820,ENSG00000095739,ENSG00000173207,ENSG00000103888,ENSG00000107281,ENSG00000105974,ENSG00000172716,ENSG00000130529,ENSG00000120992,ENSG00000063180,ENSG00000164978,ENSG00000235174,ENSG00000187134,ENSG00000180834,ENSG00000109046,ENSG00000104951,ENSG00000111530,ENSG00000158089,ENSG00000223551,ENSG00000108352,ENSG00000114737,ENSG00000255135,ENSG00000204219,ENSG00000242299,ENSG00000119917,ENSG00000122641,ENSG00000108602,ENSG00000189129,ENSG00000119917,ENSG00000185015,ENSG00000267321,ENSG00000143416,ENSG00000135679
ENSG00000136160,ENSG00000164308,ENSG00000161638,ENSG00000090382,ENSG00000005884,ENSG00000100097,ENSG00000128039,ENSG00000141294,ENSG00000146592,ENSG00000168209,ENSG00000074410,ENSG00000179943,ENSG00000139044,ENSG00000172201,ENSG00000104738,ENSG00000114346,ENSG00000166086,ENSG00000176788,ENSG00000182013,ENSG00000196154,ENSG00000175893,ENSG00000162654,ENSG00000175602,ENSG00000111341,ENSG00000147576,ENSG00000125740,ENSG00000159231,ENSG00000141424,ENSG00000104267,ENSG00000163959,ENSG00000125538,ENSG00000123689,ENSG00000166833,ENSG00000066056,ENSG00000168899,ENSG00000125170,ENSG00000100033,ENSG00000122861,ENSG00000187244,ENSG00000153395,ENSG00000136048,ENSG00000197646,ENSG00000249992,ENSG00000129009,ENSG00000248890,ENSG00000164683,ENSG00000125740,ENSG00000170011,ENSG00000106610,ENSG00000124107
