Topic 1,Topic 2,Topic 3,Topic 4,Topic 5,Topic 6,Topic 7,Topic 8,Topic 9,Topic 10,Topic 11,Topic 12,Topic 13,Topic 14,Topic 15,Topic 16,Topic 17,Topic 18,Topic 19,Topic 20,Topic 21,Topic 22,Topic 23,Topic 24,Topic 25,Topic 26,Topic 27,Topic 28,Topic 29,Topic 30,Topic 31,Topic 32,Topic 33,Topic 34,Topic 35,Topic 36,Topic 37,Topic 38
ENSG00000115414,ENSG00000187840,ENSG00000142156,ENSG00000137876,ENSG00000117632,ENSG00000139629,ENSG00000146674,ENSG00000006327,ENSG00000213722,ENSG00000236552,ENSG00000185499,ENSG00000105655,ENSG00000172164,ENSG00000196352,ENSG00000108821,ENSG00000092964,ENSG00000166033,ENSG00000116741,ENSG00000176619,ENSG00000171860,ENSG00000129009,ENSG00000206341,ENSG00000109107,ENSG00000110876,ENSG00000162616,ENSG00000058063,ENSG00000116285,ENSG00000131378,ENSG00000233429,ENSG00000128016,ENSG00000120437,ENSG00000135069,ENSG00000008256,ENSG00000162551,ENSG00000011465,ENSG00000172889,ENSG00000125966,ENSG00000141574
ENSG00000242299,ENSG00000146731,ENSG00000174640,ENSG00000197249,ENSG00000173950,ENSG00000182871,ENSG00000198142,ENSG00000105854,ENSG00000105270,ENSG00000141756,ENSG00000118503,ENSG00000170571,ENSG00000025708,ENSG00000132465,ENSG00000088836,ENSG00000131153,ENSG00000147872,ENSG00000127399,ENSG00000038427,ENSG00000204219,ENSG00000206337,ENSG00000170345,ENSG00000154153,ENSG00000171476,ENSG00000142875,ENSG00000144655,ENSG00000127337,ENSG00000103888,ENSG00000168040,ENSG00000163961,ENSG00000168615,ENSG00000101213,ENSG00000147804,ENSG00000078401,ENSG00000085788,ENSG00000108821,ENSG00000115419,ENSG00000229344
ENSG00000212802,ENSG00000157992,ENSG00000109814,ENSG00000171236,ENSG00000167772,ENSG00000104332,ENSG00000092068,ENSG00000227097,ENSG00000104267,ENSG00000249915,ENSG00000182985,ENSG00000008517,ENSG00000160180,ENSG00000099958,ENSG00000189171,ENSG00000225630,ENSG00000214530,ENSG00000185619,ENSG00000090006,ENSG00000161202,ENSG00000135678,ENSG00000135046,ENSG00000109062,ENSG00000153179,ENSG00000168209,ENSG00000130414,ENSG00000139289,ENSG00000211892,ENSG00000105197,ENSG00000106992,ENSG00000162576,ENSG00000079462,ENSG00000122852,ENSG00000111530,ENSG00000108578,ENSG00000186907,ENSG00000077984,ENSG00000105825
ENSG00000187837,ENSG00000133401,ENSG00000163359,ENSG00000213903,ENSG00000164683,ENSG00000019549,ENSG00000205420,ENSG00000141424,ENSG00000137166,ENSG00000114023,ENSG00000187134,ENSG00000168917,ENSG00000137970,ENSG00000065054,ENSG00000100097,ENSG00000143179,ENSG00000235501,ENSG00000136379,ENSG00000179820,ENSG00000188820,ENSG00000059804,ENSG00000132329,ENSG00000118971,ENSG00000106089,ENSG00000136379,ENSG00000087086,ENSG00000100097,ENSG00000099219,ENSG00000053747,ENSG00000111412,ENSG00000234851,ENSG00000153395,ENSG00000047457,ENSG00000008256,ENSG00000149328,ENSG00000179715,ENSG00000144810,ENSG00000128602
ENSG00000111275,ENSG00000161203,ENSG00000135678,ENSG00000205420,ENSG00000115267,ENSG00000157456,ENSG00000129521,ENSG00000226950,ENSG00000169469,ENSG00000109046,ENSG00000157613,ENSG00000260549,ENSG00000115457,ENSG00000168679,ENSG00000117525,ENSG00000170801,ENSG00000169738,ENSG00000269981,ENSG00000140525,ENSG00000112144,ENSG00000131711,ENSG00000164647,ENSG00000172889,ENSG00000126368,ENSG00000130529,ENSG00000111671,ENSG00000113070,ENSG00000152926,ENSG00000001084,ENSG00000096060,ENSG00000183779,ENSG00000119138,ENSG00000172724,ENSG00000143412,ENSG00000161204,ENSG00000038945,ENSG00000157992,ENSG00000144655
ENSG00000161243,ENSG00000175193,ENSG00000160124,ENSG00000013588,ENSG00000169180,ENSG00000071242,ENSG00000106025,ENSG00000137331,ENSG00000065809,ENSG00000135245,ENSG00000178934,ENSG00000198523,ENSG00000085662,ENSG00000111799,ENSG00000179604,ENSG00000008513,ENSG00000145632,ENSG00000163251,ENSG00000004776,ENSG00000119138,ENSG00000139044,ENSG00000135083,ENSG00000131477,ENSG00000244405,ENSG00000104998,ENSG00000211679,ENSG00000213058,ENSG00000184254,ENSG00000228502,ENSG00000270170,ENSG00000166741,ENSG00000242299,ENSG00000139998,ENSG00000114270,ENSG00000109472,ENSG00000168542,ENSG00000161638,ENSG00000165474
ENSG00000103316,ENSG00000113504,ENSG00000079308,ENSG00000162692,ENSG00000109814,ENSG00000173599,ENSG00000223573,ENSG00000161179,ENSG00000145014,ENSG00000119986,ENSG00000139926,ENSG00000114378,ENSG00000108551,ENSG00000091986,ENSG00000139193,ENSG00000166803,ENSG00000105655,ENSG00000227671,ENSG00000073111,ENSG00000221829,ENSG00000104419,ENSG00000175567,ENSG00000145386,ENSG00000188783,ENSG00000196187,ENSG00000166073,ENSG00000104856,ENSG00000171401,ENSG00000183508,ENSG00000163823,ENSG00000169136,ENSG00000117594,ENSG00000115380,ENSG00000141232,ENSG00000175567,ENSG00000057019,ENSG00000019169,ENSG00000226084
ENSG00000141526,ENSG00000101003,ENSG00000110092,ENSG00000109814,ENSG00000139146,ENSG00000146242,ENSG00000152583,ENSG00000184678,ENSG00000105427,ENSG00000145860,ENSG00000134759,ENSG00000141384,ENSG00000083937,ENSG00000132965,ENSG00000141510,ENSG00000205246,ENSG00000143546,ENSG00000105063,ENSG00000127337,ENSG00000136235,ENSG00000197249,ENSG00000114744,ENSG00000134531,ENSG00000165949,ENSG00000184678,ENSG00000171860,ENSG00000116661,ENSG00000179593,ENSG00000067082,ENSG00000150540,ENSG00000169710,ENSG00000071967,ENSG00000185567,ENSG00000021300,ENSG00000104093,ENSG00000157110,ENSG00000183049,ENSG00000122861
ENSG00000068079,ENSG00000175505,ENSG00000159212,ENSG00000137462,ENSG00000142632,ENSG00000134986,ENSG00000203785,ENSG00000162496,ENSG00000133026,ENSG00000101447,ENSG00000269899,ENSG00000099284,ENSG00000102760,ENSG00000086300,ENSG00000013810,ENSG00000178726,ENSG00000115641,ENSG00000139044,ENSG00000128016,ENSG00000099860,ENSG00000169429,ENSG00000006453,ENSG00000118785,ENSG00000187193,ENSG00000131016,ENSG00000105894,ENSG00000159231,ENSG00000133985,ENSG00000165507,ENSG00000139173,ENSG00000137267,ENSG00000204305,ENSG00000115112,ENSG00000165283,ENSG00000076382,ENSG00000181031,ENSG00000185499,ENSG00000179085
ENSG00000170525,ENSG00000167315,ENSG00000085377,ENSG00000143797,ENSG00000177732,ENSG00000185432,ENSG00000117394,ENSG00000143382,ENSG00000181788,ENSG00000091986,ENSG00000166592,ENSG00000101443,ENSG00000139211,ENSG00000151651,ENSG00000189058,ENSG00000011422,ENSG00000185633,ENSG00000270157,ENSG00000107140,ENSG00000114857,ENSG00000117525,ENSG00000162654,ENSG00000041982,ENSG00000171766,ENSG00000166816,ENSG00000131055,ENSG00000104419,ENSG00000162878,ENSG00000211890,ENSG00000197766,ENSG00000196154,ENSG00000162692,ENSG00000126368,ENSG00000135604,ENSG00000062716,ENSG00000130707,ENSG00000118785,ENSG00000166562
ENSG00000169439,ENSG00000105063,ENSG00000154096,ENSG00000180596,ENSG00000141424,ENSG00000164442,ENSG00000155380,ENSG00000211892,ENSG00000152377,ENSG00000107159,ENSG00000175183,ENSG00000239246,ENSG00000227766,ENSG00000101003,ENSG00000097021,ENSG00000168386,ENSG00000153885,ENSG00000119138,ENSG00000139289,ENSG00000186847,ENSG00000198848,ENSG00000182551,ENSG00000226608,ENSG00000005884,ENSG00000183628,ENSG00000129691,ENSG00000185567,ENSG00000108551,ENSG00000186891,ENSG00000158825,ENSG00000139263,ENSG00000112299,ENSG00000175505,ENSG00000175445,ENSG00000105810,ENSG00000104856,ENSG00000099860,ENSG00000143797
ENSG00000211772,ENSG00000131435,ENSG00000156804,ENSG00000169715,ENSG00000138795,ENSG00000167617,ENSG00000121578,ENSG00000113569,ENSG00000169439,ENSG00000113448,ENSG00000185338,ENSG00000066336,ENSG00000049540,ENSG00000092964,ENSG00000134690,ENSG00000137055,ENSG00000133392,ENSG00000008394,ENSG00000227097,ENSG00000185633,ENSG00000091409,ENSG00000137628,ENSG00000165449,ENSG00000255198,ENSG00000139679,ENSG00000010327,ENSG00000085117,ENSG00000101443,ENSG00000105519,ENSG00000134278,ENSG00000100413,ENSG00000165434,ENSG00000267475,ENSG00000145506,ENSG00000140526,ENSG00000108846,ENSG00000127920,ENSG00000060656
ENSG00000213853,ENSG00000161513,ENSG00000111912,ENSG00000113070,ENSG00000118849,ENSG00000072274,ENSG00000092621,ENSG00000114554,ENSG00000102760,ENSG00000110400,ENSG00000175567,ENSG00000096872,ENSG00000116016,ENSG00000159228,ENSG00000239569,ENSG00000140092,ENSG00000187244,ENSG00000099998,ENSG00000177383,ENSG00000122863,ENSG00000145194,ENSG00000169490,ENSG00000048740,ENSG00000161055,ENSG00000170190,ENSG00000198431,ENSG00000072832,ENSG00000172890,ENSG00000168878,ENSG00000197461,ENSG00000111859,ENSG00000115380,ENSG00000161281,ENSG00000074181,ENSG00000110799,ENSG00000137507,ENSG00000074527,ENSG00000006453
ENSG00000232956,ENSG00000081041,ENSG00000174348,ENSG00000187837,ENSG00000113657,ENSG00000143819,ENSG00000077152,ENSG00000211895,ENSG00000135069,ENSG00000067113,ENSG00000264281,ENSG00000105048,ENSG00000198286,ENSG00000172201,ENSG00000163993,ENSG00000162738,ENSG00000060558,ENSG00000111275,ENSG00000102878,ENSG00000103811,ENSG00000169696,ENSG00000188747,ENSG00000158825,ENSG00000108551,ENSG00000232956,ENSG00000029153,ENSG00000161204,ENSG00000095539,ENSG00000104267,ENSG00000126860,ENSG00000244187,ENSG00000137642,ENSG00000261221,ENSG00000130635,ENSG00000128342,ENSG00000101265,ENSG00000218426,ENSG00000019991
ENSG00000167656,ENSG00000006453,ENSG00000204262,ENSG00000189171,ENSG00000123689,ENSG00000061656,ENSG00000116701,ENSG00000123342,ENSG00000142512,ENSG00000130222,ENSG00000139329,ENSG00000115414,ENSG00000163513,ENSG00000116132,ENSG00000164125,ENSG00000169136,ENSG00000111834,ENSG00000109846,ENSG00000256594,ENSG00000240065,ENSG00000143367,ENSG00000106538,ENSG00000182985,ENSG00000154930,ENSG00000077152,ENSG00000109654,ENSG00000164978,ENSG00000164978,ENSG00000184436,ENSG00000236552,ENSG00000152661,ENSG00000002933,ENSG00000186832,ENSG00000169442,ENSG00000124772,ENSG00000013588,ENSG00000127603,ENSG00000103257
ENSG00000132819,ENSG00000147454,ENSG00000175893,ENSG00000177191,ENSG00000168386,ENSG00000135083,ENSG00000132465,ENSG00000166226,ENSG00000181804,ENSG00000101000,ENSG00000147535,ENSG00000176920,ENSG00000113721,ENSG00000109881,ENSG00000043093,ENSG00000173706,ENSG00000175324,ENSG00000204642,ENSG00000101213,ENSG00000106483,ENSG00000121552,ENSG00000143196,ENSG00000185950,ENSG00000175063,ENSG00000185585,ENSG00000110092,ENSG00000102760,ENSG00000132465,ENSG00000103260,ENSG00000123106,ENSG00000089351,ENSG00000166833,ENSG00000260552,ENSG00000109501,ENSG00000105270,ENSG00000125968,ENSG00000205517,ENSG00000136235
ENSG00000137331,ENSG00000140526,ENSG00000111674,ENSG00000166582,ENSG00000137801,ENSG00000094804,ENSG00000122694,ENSG00000134152,ENSG00000188783,ENSG00000101336,ENSG00000177191,ENSG00000136048,ENSG00000173918,ENSG00000162078,ENSG00000120875,ENSG00000200087,ENSG00000132965,ENSG00000146122,ENSG00000149269,ENSG00000141526,ENSG00000137642,ENSG00000134070,ENSG00000162639,ENSG00000081041,ENSG00000147576,ENSG00000107742,ENSG00000126709,ENSG00000179456,ENSG00000104894,ENSG00000116701,ENSG00000247134,ENSG00000068650,ENSG00000135069,ENSG00000019549,ENSG00000136854,ENSG00000173267,ENSG00000131097,ENSG00000132622
ENSG00000181826,ENSG00000205420,ENSG00000173852,ENSG00000135046,ENSG00000228623,ENSG00000197766,ENSG00000234851,ENSG00000211899,ENSG00000259943,ENSG00000110876,ENSG00000074410,ENSG00000153179,ENSG00000060656,ENSG00000176454,ENSG00000139263,ENSG00000233476,ENSG00000065911,ENSG00000136167,ENSG00000136689,ENSG00000119514,ENSG00000175893,ENSG00000137462,ENSG00000241794,ENSG00000158373,ENSG00000168765,ENSG00000068024,ENSG00000132688,ENSG00000225889,ENSG00000127863,ENSG00000259820,ENSG00000126803,ENSG00000139116,ENSG00000106809,ENSG00000171310,ENSG00000165434,ENSG00000164761,ENSG00000247095,ENSG00000244734
ENSG00000211899,ENSG00000260260,ENSG00000143248,ENSG00000154917,ENSG00000174939,ENSG00000134184,ENSG00000143369,ENSG00000163568,ENSG00000075651,ENSG00000167653,ENSG00000120708,ENSG00000186998,ENSG00000237649,ENSG00000174939,ENSG00000080007,ENSG00000216775,ENSG00000090382,ENSG00000134369,ENSG00000100139,ENSG00000169116,ENSG00000204642,ENSG00000066336,ENSG00000160862,ENSG00000174007,ENSG00000134508,ENSG00000134152,ENSG00000168234,ENSG00000168758,ENSG00000104427,ENSG00000135677,ENSG00000133466,ENSG00000163251,ENSG00000197822,ENSG00000205246,ENSG00000165949,ENSG00000226332,ENSG00000124406,ENSG00000135047
ENSG00000180530,ENSG00000166780,ENSG00000142945,ENSG00000245694,ENSG00000130635,ENSG00000112312,ENSG00000068079,ENSG00000242861,ENSG00000101255,ENSG00000122679,ENSG00000225808,ENSG00000145632,ENSG00000124006,ENSG00000173706,ENSG00000164023,ENSG00000107742,ENSG00000166816,ENSG00000177575,ENSG00000133687,ENSG00000076864,ENSG00000080503,ENSG00000138678,ENSG00000128298,ENSG00000202198,ENSG00000198189,ENSG00000116678,ENSG00000172236,ENSG00000231770,ENSG00000065833,ENSG00000133816,ENSG00000127528,ENSG00000129009,ENSG00000203785,ENSG00000038427,ENSG00000119922,ENSG00000185950,ENSG00000181744,ENSG00000114737
ENSG00000172602,ENSG00000136425,ENSG00000139350,ENSG00000141696,ENSG00000244405,ENSG00000154277,ENSG00000129009,ENSG00000134202,ENSG00000177337,ENSG00000135002,ENSG00000106123,ENSG00000149781,ENSG00000185950,ENSG00000082196,ENSG00000172724,ENSG00000085117,ENSG00000104635,ENSG00000244187,ENSG00000141741,ENSG00000186517,ENSG00000072071,ENSG00000116711,ENSG00000140379,ENSG00000169136,ENSG00000116574,ENSG00000136514,ENSG00000132819,ENSG00000165949,ENSG00000126860,ENSG00000175445,ENSG00000128284,ENSG00000156968,ENSG00000163872,ENSG00000257702,ENSG00000189366,ENSG00000147889,ENSG00000165716,ENSG00000181744
