Topic 1,Topic 2,Topic 3,Topic 4,Topic 5,Topic 6,Topic 7,Topic 8,Topic 9,Topic 10,Topic 11,Topic 12,Topic 13,Topic 14
ENSG00000115414,ENSG00000175193,ENSG00000142156,ENSG00000197249,ENSG00000186340,ENSG00000197249,ENSG00000092068,ENSG00000105854,ENSG00000198467,ENSG00000236552,ENSG00000139329,ENSG00000105655,ENSG00000120885,ENSG00000159228
ENSG00000072071,ENSG00000113504,ENSG00000174640,ENSG00000137876,ENSG00000113924,ENSG00000139629,ENSG00000068079,ENSG00000006327,ENSG00000177337,ENSG00000141756,ENSG00000157613,ENSG00000145632,ENSG00000160180,ENSG00000142102
ENSG00000242299,ENSG00000081041,ENSG00000174348,ENSG00000114737,ENSG00000115267,ENSG00000134986,ENSG00000146674,ENSG00000115758,ENSG00000103811,ENSG00000135245,ENSG00000147535,ENSG00000101443,ENSG00000123610,ENSG00000186517
ENSG00000212802,ENSG00000131435,ENSG00000152583,ENSG00000101384,ENSG00000167772,ENSG00000164442,ENSG00000141741,ENSG00000141424,ENSG00000152377,ENSG00000068650,ENSG00000139926,ENSG00000162772,ENSG00000166165,ENSG00000196352
ENSG00000141526,ENSG00000105063,ENSG00000141510,ENSG00000154917,ENSG00000169180,ENSG00000186847,ENSG00000129009,ENSG00000135047,ENSG00000023909,ENSG00000146731,ENSG00000141736,ENSG00000198523,ENSG00000107742,ENSG00000100504
ENSG00000162738,ENSG00000041982,ENSG00000128311,ENSG00000164078,ENSG00000115963,ENSG00000198722,ENSG00000160255,ENSG00000049540,ENSG00000116285,ENSG00000005884,ENSG00000187134,ENSG00000064205,ENSG00000173918,ENSG00000070731
ENSG00000170525,ENSG00000146731,ENSG00000111912,ENSG00000203668,ENSG00000129009,ENSG00000175567,ENSG00000155380,ENSG00000131979,ENSG00000169385,ENSG00000101000,ENSG00000112144,ENSG00000099284,ENSG00000196975,ENSG00000116132
ENSG00000136514,ENSG00000152818,ENSG00000160124,ENSG00000173281,ENSG00000169116,ENSG00000185432,ENSG00000080573,ENSG00000112699,ENSG00000181788,ENSG00000142156,ENSG00000123384,ENSG00000170571,ENSG00000137970,ENSG00000105088
ENSG00000137331,ENSG00000038427,ENSG00000159212,ENSG00000026103,ENSG00000173950,ENSG00000171560,ENSG00000198142,ENSG00000226950,ENSG00000135069,ENSG00000157110,ENSG00000269899,ENSG00000214975,ENSG00000091409,ENSG00000121769
ENSG00000145604,ENSG00000260260,ENSG00000071539,ENSG00000157992,ENSG00000168646,ENSG00000214389,ENSG00000116701,ENSG00000163568,ENSG00000260260,ENSG00000119986,ENSG00000181788,ENSG00000148803,ENSG00000114346,ENSG00000140526
ENSG00000161243,ENSG00000129691,ENSG00000238142,ENSG00000183508,ENSG00000113504,ENSG00000102524,ENSG00000092621,ENSG00000114554,ENSG00000187134,ENSG00000249915,ENSG00000121858,ENSG00000066336,ENSG00000137628,ENSG00000154217
ENSG00000213853,ENSG00000157992,ENSG00000204219,ENSG00000113070,ENSG00000172543,ENSG00000154309,ENSG00000139239,ENSG00000107175,ENSG00000204291,ENSG00000119917,ENSG00000134759,ENSG00000114378,ENSG00000172164,ENSG00000168679
ENSG00000119917,ENSG00000108821,ENSG00000267519,ENSG00000130755,ENSG00000230795,ENSG00000173599,ENSG00000129521,ENSG00000113569,ENSG00000152137,ENSG00000133321,ENSG00000175567,ENSG00000213757,ENSG00000139044,ENSG00000163993
ENSG00000183779,ENSG00000161203,ENSG00000120217,ENSG00000143797,ENSG00000142632,ENSG00000116717,ENSG00000234851,ENSG00000177303,ENSG00000101255,ENSG00000122679,ENSG00000090621,ENSG00000168917,ENSG00000162433,ENSG00000074416
ENSG00000111275,ENSG00000134202,ENSG00000143320,ENSG00000137462,ENSG00000125845,ENSG00000131037,ENSG00000179943,ENSG00000227097,ENSG00000065809,ENSG00000109046,ENSG00000097021,ENSG00000248485,ENSG00000101384,ENSG00000132465
ENSG00000101000,ENSG00000235174,ENSG00000171051,ENSG00000245694,ENSG00000054598,ENSG00000164949,ENSG00000179085,ENSG00000172201,ENSG00000070501,ENSG00000085117,ENSG00000120708,ENSG00000114737,ENSG00000119630,ENSG00000099958
ENSG00000197405,ENSG00000141574,ENSG00000184436,ENSG00000167711,ENSG00000117632,ENSG00000137699,ENSG00000147889,ENSG00000120159,ENSG00000108691,ENSG00000175701,ENSG00000184371,ENSG00000151914,ENSG00000167797,ENSG00000104998
ENSG00000181826,ENSG00000140526,ENSG00000168209,ENSG00000171557,ENSG00000225492,ENSG00000104894,ENSG00000114631,ENSG00000134202,ENSG00000180530,ENSG00000233622,ENSG00000214530,ENSG00000129003,ENSG00000198502,ENSG00000213722
ENSG00000187837,ENSG00000163815,ENSG00000149260,ENSG00000213903,ENSG00000177732,ENSG00000061656,ENSG00000117394,ENSG00000175183,ENSG00000104267,ENSG00000131477,ENSG00000166562,ENSG00000147872,ENSG00000159228,ENSG00000134759
ENSG00000180530,ENSG00000136425,ENSG00000120129,ENSG00000125772,ENSG00000109814,ENSG00000135083,ENSG00000008394,ENSG00000184678,ENSG00000085117,ENSG00000115657,ENSG00000114115,ENSG00000104738,ENSG00000049540,ENSG00000204642
ENSG00000197256,ENSG00000172893,ENSG00000099337,ENSG00000155465,ENSG00000123689,ENSG00000182871,ENSG00000120756,ENSG00000242861,ENSG00000003436,ENSG00000164292,ENSG00000107562,ENSG00000108176,ENSG00000125775,ENSG00000125968
