Topic 1,Topic 2,Topic 3,Topic 4,Topic 5,Topic 6,Topic 7,Topic 8,Topic 9,Topic 10,Topic 11,Topic 12,Topic 13,Topic 14,Topic 15,Topic 16,Topic 17,Topic 18,Topic 19,Topic 20,Topic 21,Topic 22,Topic 23,Topic 24,Topic 25,Topic 26,Topic 27,Topic 28,Topic 29,Topic 30,Topic 31,Topic 32,Topic 33,Topic 34,Topic 35,Topic 36,Topic 37,Topic 38,Topic 39,Topic 40,Topic 41,Topic 42,Topic 43,Topic 44,Topic 45,Topic 46,Topic 47,Topic 48,Topic 49,Topic 50,Topic 51,Topic 52,Topic 53,Topic 54
ENSG00000211896,ENSG00000111341,ENSG00000173432,ENSG00000211892,ENSG00000202198,ENSG00000164919,ENSG00000100985,ENSG00000126709,ENSG00000145824,ENSG00000163220,ENSG00000197956,ENSG00000211893,ENSG00000126709,ENSG00000172551,ENSG00000111341,ENSG00000184009,ENSG00000145824,ENSG00000111341,ENSG00000111341,ENSG00000153002,ENSG00000111341,ENSG00000159763,ENSG00000159763,ENSG00000160180,ENSG00000211896,ENSG00000163631,ENSG00000124107,ENSG00000153002,ENSG00000211896,ENSG00000211895,ENSG00000186847,ENSG00000106688,ENSG00000211679,ENSG00000111341,ENSG00000108298,ENSG00000185885,ENSG00000143632,ENSG00000100985,ENSG00000184009,ENSG00000202198,ENSG00000197956,ENSG00000187837,ENSG00000211890,ENSG00000171560,ENSG00000211895,ENSG00000141424,ENSG00000160888,ENSG00000211899,ENSG00000143632,ENSG00000202198,ENSG00000202198,ENSG00000111341,ENSG00000141424,ENSG00000173432
ENSG00000034510,ENSG00000211895,ENSG00000099194,ENSG00000225972,ENSG00000200087,ENSG00000165949,ENSG00000142552,ENSG00000160180,ENSG00000104267,ENSG00000143556,ENSG00000125730,ENSG00000211679,ENSG00000206503,ENSG00000189058,ENSG00000105894,ENSG00000175063,ENSG00000115461,ENSG00000133321,ENSG00000112306,ENSG00000100604,ENSG00000120738,ENSG00000161634,ENSG00000034510,ENSG00000159763,ENSG00000211677,ENSG00000115461,ENSG00000034510,ENSG00000126709,ENSG00000211892,ENSG00000111341,ENSG00000186081,ENSG00000122176,ENSG00000211893,ENSG00000175899,ENSG00000172057,ENSG00000141424,ENSG00000198125,ENSG00000118785,ENSG00000141424,ENSG00000200087,ENSG00000211895,ENSG00000187608,ENSG00000211895,ENSG00000132693,ENSG00000115461,ENSG00000141736,ENSG00000211895,ENSG00000211679,ENSG00000104879,ENSG00000200087,ENSG00000038427,ENSG00000211895,ENSG00000152661,ENSG00000170345
ENSG00000112306,ENSG00000164919,ENSG00000170345,ENSG00000161634,ENSG00000259001,ENSG00000108298,ENSG00000142173,ENSG00000153002,ENSG00000138449,ENSG00000143546,ENSG00000115461,ENSG00000211677,ENSG00000187608,ENSG00000179593,ENSG00000211895,ENSG00000123975,ENSG00000106366,ENSG00000159388,ENSG00000197956,ENSG00000160180,ENSG00000115461,ENSG00000089199,ENSG00000161634,ENSG00000160862,ENSG00000198502,ENSG00000147471,ENSG00000104332,ENSG00000135346,ENSG00000211677,ENSG00000115380,ENSG00000197956,ENSG00000161634,ENSG00000129437,ENSG00000122877,ENSG00000141741,ENSG00000140526,ENSG00000100985,ENSG00000129437,ENSG00000169710,ENSG00000251791,ENSG00000135046,ENSG00000099953,ENSG00000132465,ENSG00000158874,ENSG00000129437,ENSG00000123124,ENSG00000167676,ENSG00000211893,ENSG00000111245,ENSG00000259001,ENSG00000071967,ENSG00000149273,ENSG00000185885,ENSG00000120738
ENSG00000050165,ENSG00000211890,ENSG00000120738,ENSG00000179593,ENSG00000208772,ENSG00000141741,ENSG00000138080,ENSG00000211895,ENSG00000134352,ENSG00000102837,ENSG00000211896,ENSG00000211892,ENSG00000034510,ENSG00000160862,ENSG00000108298,ENSG00000034510,ENSG00000170525,ENSG00000141424,ENSG00000154096,ENSG00000163631,ENSG00000110092,ENSG00000160862,ENSG00000187837,ENSG00000117984,ENSG00000211679,ENSG00000113739,ENSG00000160307,ENSG00000164919,ENSG00000211899,ENSG00000211893,ENSG00000196754,ENSG00000109436,ENSG00000211895,ENSG00000112759,ENSG00000266469,ENSG00000109062,ENSG00000111341,ENSG00000117632,ENSG00000137166,ENSG00000212443,ENSG00000132465,ENSG00000126709,ENSG00000100985,ENSG00000118137,ENSG00000211890,ENSG00000184678,ENSG00000170323,ENSG00000254709,ENSG00000168530,ENSG00000208772,ENSG00000108021,ENSG00000113739,ENSG00000126709,ENSG00000186847
ENSG00000111341,ENSG00000197956,ENSG00000125740,ENSG00000211895,ENSG00000212232,ENSG00000120885,ENSG00000141424,ENSG00000152661,ENSG00000106688,ENSG00000124102,ENSG00000112306,ENSG00000211897,ENSG00000137959,ENSG00000155368,ENSG00000161055,ENSG00000160932,ENSG00000111341,ENSG00000129009,ENSG00000034510,ENSG00000141424,ENSG00000141424,ENSG00000100604,ENSG00000134531,ENSG00000126709,ENSG00000169245,ENSG00000111341,ENSG00000196154,ENSG00000187608,ENSG00000211893,ENSG00000186847,ENSG00000167768,ENSG00000159212,ENSG00000254709,ENSG00000237973,ENSG00000131771,ENSG00000158373,ENSG00000141424,ENSG00000149257,ENSG00000112306,ENSG00000208772,ENSG00000184009,ENSG00000160180,ENSG00000211677,ENSG00000125144,ENSG00000118785,ENSG00000152661,ENSG00000123384,ENSG00000211892,ENSG00000125414,ENSG00000269900,ENSG00000138434,ENSG00000138449,ENSG00000246705,ENSG00000125740
ENSG00000126709,ENSG00000184009,ENSG00000128016,ENSG00000268751,ENSG00000269900,ENSG00000103257,ENSG00000034510,ENSG00000109062,ENSG00000167549,ENSG00000131771,ENSG00000110092,ENSG00000211896,ENSG00000111335,ENSG00000204936,ENSG00000159763,ENSG00000117632,ENSG00000118523,ENSG00000152661,ENSG00000130635,ENSG00000110092,ENSG00000211895,ENSG00000114200,ENSG00000126709,ENSG00000103490,ENSG00000211897,ENSG00000120885,ENSG00000140545,ENSG00000143320,ENSG00000124107,ENSG00000162896,ENSG00000186832,ENSG00000012660,ENSG00000090382,ENSG00000196091,ENSG00000161395,ENSG00000113739,ENSG00000115461,ENSG00000034510,ENSG00000143753,ENSG00000252481,ENSG00000122176,ENSG00000099194,ENSG00000142871,ENSG00000171564,ENSG00000111716,ENSG00000185499,ENSG00000187608,ENSG00000162654,ENSG00000101470,ENSG00000238741,ENSG00000124107,ENSG00000177606,ENSG00000111341,ENSG00000166482
ENSG00000167191,ENSG00000162078,ENSG00000123689,ENSG00000159763,ENSG00000238795,ENSG00000075624,ENSG00000196154,ENSG00000120738,ENSG00000104763,ENSG00000186832,ENSG00000109062,ENSG00000254709,ENSG00000119922,ENSG00000124107,ENSG00000160862,ENSG00000010292,ENSG00000112306,ENSG00000115461,ENSG00000111716,ENSG00000164919,ENSG00000116133,ENSG00000187097,ENSG00000187608,ENSG00000143320,ENSG00000211890,ENSG00000184009,ENSG00000163017,ENSG00000101210,ENSG00000172551,ENSG00000116285,ENSG00000175793,ENSG00000071967,ENSG00000211892,ENSG00000118523,ENSG00000125686,ENSG00000140443,ENSG00000104267,ENSG00000126709,ENSG00000084207,ENSG00000255823,ENSG00000113739,ENSG00000108298,ENSG00000211679,ENSG00000171557,ENSG00000162896,ENSG00000134759,ENSG00000108551,ENSG00000090382,ENSG00000092054,ENSG00000212664,ENSG00000228663,ENSG00000100342,ENSG00000211895,ENSG00000128016
ENSG00000075624,ENSG00000034510,ENSG00000166482,ENSG00000211677,ENSG00000263740,ENSG00000185885,ENSG00000141736,ENSG00000211899,ENSG00000171428,ENSG00000118849,ENSG00000008394,ENSG00000211895,ENSG00000135114,ENSG00000169919,ENSG00000124107,ENSG00000073111,ENSG00000162576,ENSG00000211895,ENSG00000242574,ENSG00000135346,ENSG00000130707,ENSG00000107438,ENSG00000131771,ENSG00000152661,ENSG00000090382,ENSG00000171428,ENSG00000084207,ENSG00000142875,ENSG00000268751,ENSG00000132465,ENSG00000075618,ENSG00000112996,ENSG00000160862,ENSG00000160862,ENSG00000141736,ENSG00000168743,ENSG00000101470,ENSG00000206503,ENSG00000185499,ENSG00000259001,ENSG00000118785,ENSG00000214530,ENSG00000142156,ENSG00000229314,ENSG00000126709,ENSG00000188895,ENSG00000141424,ENSG00000066923,ENSG00000175084,ENSG00000263740,ENSG00000186395,ENSG00000233622,ENSG00000233622,ENSG00000177606
ENSG00000183087,ENSG00000104951,ENSG00000167676,ENSG00000110492,ENSG00000212607,ENSG00000095739,ENSG00000175899,ENSG00000165949,ENSG00000179456,ENSG00000182853,ENSG00000152661,ENSG00000105369,ENSG00000119917,ENSG00000096088,ENSG00000141424,ENSG00000101132,ENSG00000108298,ENSG00000145824,ENSG00000211896,ENSG00000112562,ENSG00000139211,ENSG00000183569,ENSG00000211895,ENSG00000075624,ENSG00000211892,ENSG00000104381,ENSG00000112306,ENSG00000117472,ENSG00000211897,ENSG00000118785,ENSG00000084207,ENSG00000120875,ENSG00000225972,ENSG00000162896,ENSG00000218227,ENSG00000109436,ENSG00000145824,ENSG00000123975,ENSG00000232573,ENSG00000263740,ENSG00000136457,ENSG00000110092,ENSG00000128016,ENSG00000110245,ENSG00000107796,ENSG00000137331,ENSG00000079435,ENSG00000118849,ENSG00000198125,ENSG00000212232,ENSG00000104447,ENSG00000171236,ENSG00000130193,ENSG00000123689
ENSG00000159388,ENSG00000171033,ENSG00000186847,ENSG00000211893,ENSG00000075624,ENSG00000125686,ENSG00000173372,ENSG00000185499,ENSG00000170345,ENSG00000241794,ENSG00000162078,ENSG00000172724,ENSG00000197956,ENSG00000183569,ENSG00000146731,ENSG00000101224,ENSG00000120738,ENSG00000116667,ENSG00000102837,ENSG00000142875,ENSG00000272335,ENSG00000172551,ENSG00000112306,ENSG00000109062,ENSG00000034510,ENSG00000149269,ENSG00000243955,ENSG00000130303,ENSG00000211679,ENSG00000173372,ENSG00000170477,ENSG00000126709,ENSG00000198502,ENSG00000135052,ENSG00000008838,ENSG00000105048,ENSG00000180573,ENSG00000228288,ENSG00000126709,ENSG00000269900,ENSG00000034510,ENSG00000108344,ENSG00000213088,ENSG00000163631,ENSG00000187837,ENSG00000143320,ENSG00000135218,ENSG00000163220,ENSG00000114854,ENSG00000075624,ENSG00000211893,ENSG00000034510,ENSG00000160862,ENSG00000186081
ENSG00000135046,ENSG00000211897,ENSG00000120129,ENSG00000117984,ENSG00000111341,ENSG00000169442,ENSG00000178372,ENSG00000115461,ENSG00000159388,ENSG00000175793,ENSG00000141736,ENSG00000206503,ENSG00000115267,ENSG00000100031,ENSG00000211896,ENSG00000154277,ENSG00000211893,ENSG00000090382,ENSG00000125730,ENSG00000109472,ENSG00000211890,ENSG00000179593,ENSG00000115594,ENSG00000079462,ENSG00000211893,ENSG00000147535,ENSG00000249992,ENSG00000183779,ENSG00000254709,ENSG00000182853,ENSG00000081277,ENSG00000196091,ENSG00000211772,ENSG00000122694,ENSG00000073605,ENSG00000126709,ENSG00000211890,ENSG00000169710,ENSG00000116133,ENSG00000075624,ENSG00000148154,ENSG00000233622,ENSG00000107796,ENSG00000257017,ENSG00000167034,ENSG00000189334,ENSG00000167588,ENSG00000169245,ENSG00000130598,ENSG00000168298,ENSG00000263740,ENSG00000074410,ENSG00000159763,ENSG00000107796
ENSG00000115461,ENSG00000169245,ENSG00000151726,ENSG00000115461,ENSG00000118523,ENSG00000197956,ENSG00000204044,ENSG00000106927,ENSG00000104368,ENSG00000124107,ENSG00000118523,ENSG00000130203,ENSG00000168394,ENSG00000067064,ENSG00000126709,ENSG00000176890,ENSG00000034510,ENSG00000108179,ENSG00000206503,ENSG00000143248,ENSG00000099194,ENSG00000197249,ENSG00000120738,ENSG00000136770,ENSG00000141424,ENSG00000141582,ENSG00000105202,ENSG00000108176,ENSG00000178372,ENSG00000171346,ENSG00000054598,ENSG00000135549,ENSG00000211896,ENSG00000107796,ENSG00000108306,ENSG00000134759,ENSG00000075624,ENSG00000169245,ENSG00000077514,ENSG00000212232,ENSG00000120875,ENSG00000266469,ENSG00000189058,ENSG00000205364,ENSG00000106483,ENSG00000211895,ENSG00000148180,ENSG00000211896,ENSG00000180209,ENSG00000245532,ENSG00000245532,ENSG00000182481,ENSG00000163536,ENSG00000157404
ENSG00000130303,ENSG00000168913,ENSG00000148180,ENSG00000126709,ENSG00000201302,ENSG00000173369,ENSG00000211890,ENSG00000112378,ENSG00000145632,ENSG00000205420,ENSG00000175899,ENSG00000007312,ENSG00000160180,ENSG00000134184,ENSG00000120738,ENSG00000126709,ENSG00000170801,ENSG00000002834,ENSG00000168209,ENSG00000150687,ENSG00000034510,ENSG00000160180,ENSG00000169710,ENSG00000214530,ENSG00000129437,ENSG00000183779,ENSG00000109846,ENSG00000109436,ENSG00000090382,ENSG00000166750,ENSG00000102554,ENSG00000187244,ENSG00000172724,ENSG00000160888,ENSG00000167258,ENSG00000108932,ENSG00000206503,ENSG00000147677,ENSG00000211679,ENSG00000034510,ENSG00000126709,ENSG00000143369,ENSG00000166482,ENSG00000091583,ENSG00000189058,ENSG00000140403,ENSG00000164056,ENSG00000106565,ENSG00000196091,ENSG00000212443,ENSG00000183779,ENSG00000137331,ENSG00000165949,ENSG00000180914
ENSG00000211895,ENSG00000104332,ENSG00000169692,ENSG00000104738,ENSG00000159388,ENSG00000099194,ENSG00000162576,ENSG00000181019,ENSG00000130635,ENSG00000148346,ENSG00000101210,ENSG00000179344,ENSG00000140105,ENSG00000156968,ENSG00000114631,ENSG00000137166,ENSG00000122176,ENSG00000110092,ENSG00000175061,ENSG00000164125,ENSG00000119138,ENSG00000121858,ENSG00000168743,ENSG00000074410,ENSG00000227507,ENSG00000185885,ENSG00000211895,ENSG00000084444,ENSG00000148346,ENSG00000197956,ENSG00000140545,ENSG00000131781,ENSG00000227507,ENSG00000169692,ENSG00000143536,ENSG00000233622,ENSG00000184009,ENSG00000111341,ENSG00000092068,ENSG00000199477,ENSG00000141424,ENSG00000133321,ENSG00000171223,ENSG00000105697,ENSG00000213281,ENSG00000131844,ENSG00000174807,ENSG00000227507,ENSG00000170290,ENSG00000240877,ENSG00000131771,ENSG00000235552,ENSG00000034510,ENSG00000109846
ENSG00000178695,ENSG00000163993,ENSG00000107796,ENSG00000149257,ENSG00000225630,ENSG00000111331,ENSG00000102837,ENSG00000012660,ENSG00000186340,ENSG00000160213,ENSG00000211890,ENSG00000132465,ENSG00000115461,ENSG00000158104,ENSG00000169245,ENSG00000114631,ENSG00000075624,ENSG00000034510,ENSG00000134202,ENSG00000180573,ENSG00000170323,ENSG00000165272,ENSG00000178372,ENSG00000071967,ENSG00000163017,ENSG00000101439,ENSG00000178343,ENSG00000160180,ENSG00000179593,ENSG00000184009,ENSG00000169908,ENSG00000159763,ENSG00000149273,ENSG00000104490,ENSG00000034510,ENSG00000143320,ENSG00000109062,ENSG00000185885,ENSG00000143412,ENSG00000245532,ENSG00000160932,ENSG00000115461,ENSG00000107562,ENSG00000197249,ENSG00000175063,ENSG00000148154,ENSG00000117984,ENSG00000169442,ENSG00000239474,ENSG00000225630,ENSG00000180530,ENSG00000159189,ENSG00000122862,ENSG00000120129
ENSG00000178896,ENSG00000186395,ENSG00000004799,ENSG00000115457,ENSG00000240877,ENSG00000211892,ENSG00000245910,ENSG00000242265,ENSG00000115461,ENSG00000118785,ENSG00000112685,ENSG00000173372,ENSG00000103257,ENSG00000198682,ENSG00000173372,ENSG00000110492,ENSG00000013588,ENSG00000108298,ENSG00000140526,ENSG00000187244,ENSG00000120129,ENSG00000012660,ENSG00000142871,ENSG00000218175,ENSG00000102879,ENSG00000028116,ENSG00000100985,ENSG00000184678,ENSG00000227507,ENSG00000132470,ENSG00000203782,ENSG00000177606,ENSG00000211677,ENSG00000127990,ENSG00000131748,ENSG00000002834,ENSG00000104879,ENSG00000143556,ENSG00000074410,ENSG00000142156,ENSG00000159388,ENSG00000211895,ENSG00000091986,ENSG00000135094,ENSG00000137804,ENSG00000126709,ENSG00000071967,ENSG00000172724,ENSG00000164879,ENSG00000169908,ENSG00000273449,ENSG00000182326,ENSG00000089127,ENSG00000167676
ENSG00000160180,ENSG00000211896,ENSG00000104332,ENSG00000169710,ENSG00000212443,ENSG00000161395,ENSG00000118523,ENSG00000169710,ENSG00000159763,ENSG00000133048,ENSG00000172057,ENSG00000159189,ENSG00000165949,ENSG00000134201,ENSG00000245848,ENSG00000211896,ENSG00000171992,ENSG00000123124,ENSG00000073060,ENSG00000214530,ENSG00000164919,ENSG00000101443,ENSG00000145824,ENSG00000103024,ENSG00000160180,ENSG00000120738,ENSG00000111716,ENSG00000197457,ENSG00000099958,ENSG00000182578,ENSG00000186395,ENSG00000152661,ENSG00000206341,ENSG00000142871,ENSG00000143753,ENSG00000108829,ENSG00000173991,ENSG00000090382,ENSG00000111716,ENSG00000270640,ENSG00000128311,ENSG00000108829,ENSG00000130203,ENSG00000205362,ENSG00000157404,ENSG00000146476,ENSG00000110492,ENSG00000206503,ENSG00000177791,ENSG00000126709,ENSG00000111341,ENSG00000130635,ENSG00000008735,ENSG00000175899
ENSG00000233622,ENSG00000132470,ENSG00000244734,ENSG00000166226,ENSG00000120875,ENSG00000143320,ENSG00000206503,ENSG00000034510,ENSG00000113739,ENSG00000178934,ENSG00000169908,ENSG00000139193,ENSG00000162407,ENSG00000269235,ENSG00000136235,ENSG00000101412,ENSG00000196205,ENSG00000118785,ENSG00000164919,ENSG00000151552,ENSG00000145824,ENSG00000120875,ENSG00000132688,ENSG00000171428,ENSG00000172724,ENSG00000141424,ENSG00000172201,ENSG00000104381,ENSG00000169442,ENSG00000170345,ENSG00000161249,ENSG00000165272,ENSG00000140379,ENSG00000034510,ENSG00000108349,ENSG00000008735,ENSG00000105048,ENSG00000175899,ENSG00000034510,ENSG00000240877,ENSG00000124126,ENSG00000120885,ENSG00000164949,ENSG00000176919,ENSG00000125730,ENSG00000087301,ENSG00000127528,ENSG00000211677,ENSG00000077522,ENSG00000232043,ENSG00000146729,ENSG00000198502,ENSG00000116133,ENSG00000148180
ENSG00000147677,ENSG00000152661,ENSG00000109846,ENSG00000189334,ENSG00000238741,ENSG00000109062,ENSG00000187837,ENSG00000117984,ENSG00000145569,ENSG00000211896,ENSG00000189334,ENSG00000102879,ENSG00000068079,ENSG00000162882,ENSG00000166825,ENSG00000182272,ENSG00000112378,ENSG00000144655,ENSG00000175899,ENSG00000003989,ENSG00000011465,ENSG00000268751,ENSG00000095321,ENSG00000034510,ENSG00000254709,ENSG00000110092,ENSG00000073756,ENSG00000112996,ENSG00000130203,ENSG00000102837,ENSG00000134755,ENSG00000141424,ENSG00000197956,ENSG00000196405,ENSG00000178307,ENSG00000124107,ENSG00000246705,ENSG00000112306,ENSG00000104763,ENSG00000184009,ENSG00000075624,ENSG00000034510,ENSG00000175899,ENSG00000135245,ENSG00000269936,ENSG00000108298,ENSG00000122176,ENSG00000250182,ENSG00000196296,ENSG00000237705,ENSG00000249592,ENSG00000186665,ENSG00000163631,ENSG00000137077
ENSG00000115963,ENSG00000117399,ENSG00000180914,ENSG00000164919,ENSG00000120738,ENSG00000152377,ENSG00000008441,ENSG00000111885,ENSG00000152661,ENSG00000186395,ENSG00000168461,ENSG00000107317,ENSG00000185745,ENSG00000116774,ENSG00000104341,ENSG00000180543,ENSG00000163993,ENSG00000106565,ENSG00000237973,ENSG00000132639,ENSG00000100985,ENSG00000237940,ENSG00000132465,ENSG00000169738,ENSG00000173894,ENSG00000163513,ENSG00000116157,ENSG00000013583,ENSG00000163220,ENSG00000183779,ENSG00000124102,ENSG00000211899,ENSG00000189334,ENSG00000125730,ENSG00000188895,ENSG00000101104,ENSG00000109436,ENSG00000165949,ENSG00000176485,ENSG00000238741,ENSG00000130303,ENSG00000013588,ENSG00000137077,ENSG00000104267,ENSG00000169908,ENSG00000211677,ENSG00000173432,ENSG00000099958,ENSG00000129170,ENSG00000212607,ENSG00000251791,ENSG00000123975,ENSG00000242265,ENSG00000118523
ENSG00000211899,ENSG00000122176,ENSG00000142871,ENSG00000113083,ENSG00000034510,ENSG00000173457,ENSG00000260549,ENSG00000141232,ENSG00000170271,ENSG00000141741,ENSG00000108298,ENSG00000135916,ENSG00000109472,ENSG00000141736,ENSG00000101443,ENSG00000163923,ENSG00000104332,ENSG00000067064,ENSG00000102802,ENSG00000136457,ENSG00000152661,ENSG00000104368,ENSG00000130303,ENSG00000141424,ENSG00000107317,ENSG00000189058,ENSG00000162551,ENSG00000105290,ENSG00000163131,ENSG00000084207,ENSG00000124107,ENSG00000151208,ENSG00000130208,ENSG00000171346,ENSG00000174721,ENSG00000104447,ENSG00000164919,ENSG00000160781,ENSG00000176907,ENSG00000135052,ENSG00000181788,ENSG00000161395,ENSG00000129009,ENSG00000135744,ENSG00000164403,ENSG00000114529,ENSG00000177606,ENSG00000115415,ENSG00000173991,ENSG00000255823,ENSG00000197714,ENSG00000164764,ENSG00000175324,ENSG00000133392
