Topic 1,Topic 2,Topic 3,Topic 4,Topic 5,Topic 6,Topic 7,Topic 8,Topic 9,Topic 10,Topic 11,Topic 12,Topic 13,Topic 14,Topic 15,Topic 16,Topic 17,Topic 18,Topic 19,Topic 20,Topic 21,Topic 22,Topic 23,Topic 24,Topic 25,Topic 26,Topic 27,Topic 28,Topic 29
ENSG00000211890,ENSG00000189058,ENSG00000170323,ENSG00000211892,ENSG00000202198,ENSG00000108298,ENSG00000143632,ENSG00000164919,ENSG00000173432,ENSG00000163220,ENSG00000110092,ENSG00000112306,ENSG00000187608,ENSG00000211895,ENSG00000172551,ENSG00000123975,ENSG00000145824,ENSG00000152661,ENSG00000160180,ENSG00000153002,ENSG00000120738,ENSG00000104267,ENSG00000108298,ENSG00000159763,ENSG00000129437,ENSG00000163631,ENSG00000109846,ENSG00000100985,ENSG00000211896
ENSG00000211895,ENSG00000211890,ENSG00000166819,ENSG00000211899,ENSG00000200087,ENSG00000141736,ENSG00000104879,ENSG00000101210,ENSG00000170323,ENSG00000143556,ENSG00000115461,ENSG00000118785,ENSG00000126709,ENSG00000149257,ENSG00000189058,ENSG00000117632,ENSG00000034510,ENSG00000183779,ENSG00000186340,ENSG00000160180,ENSG00000164879,ENSG00000111341,ENSG00000163220,ENSG00000161634,ENSG00000211890,ENSG00000115461,ENSG00000243955,ENSG00000211899,ENSG00000211677
ENSG00000132465,ENSG00000211895,ENSG00000167676,ENSG00000159763,ENSG00000212232,ENSG00000132693,ENSG00000111245,ENSG00000187837,ENSG00000128016,ENSG00000143546,ENSG00000162482,ENSG00000211895,ENSG00000206503,ENSG00000237039,ENSG00000159763,ENSG00000154277,ENSG00000244398,ENSG00000184009,ENSG00000115461,ENSG00000164919,ENSG00000170323,ENSG00000117984,ENSG00000141736,ENSG00000089199,ENSG00000090382,ENSG00000141424,ENSG00000140545,ENSG00000167768,ENSG00000211893
ENSG00000120738,ENSG00000141424,ENSG00000173432,ENSG00000161634,ENSG00000238741,ENSG00000229314,ENSG00000198125,ENSG00000108298,ENSG00000170345,ENSG00000124107,ENSG00000171428,ENSG00000034510,ENSG00000119922,ENSG00000141232,ENSG00000179593,ENSG00000187608,ENSG00000214078,ENSG00000113739,ENSG00000118785,ENSG00000141424,ENSG00000175084,ENSG00000164403,ENSG00000124107,ENSG00000100604,ENSG00000211897,ENSG00000113739,ENSG00000175899,ENSG00000163220,ENSG00000211679
ENSG00000186847,ENSG00000115461,ENSG00000211445,ENSG00000172724,ENSG00000212443,ENSG00000125686,ENSG00000168530,ENSG00000100604,ENSG00000125740,ENSG00000124102,ENSG00000109062,ENSG00000111341,ENSG00000119917,ENSG00000186847,ENSG00000204936,ENSG00000149273,ENSG00000186847,ENSG00000130635,ENSG00000171346,ENSG00000117472,ENSG00000177666,ENSG00000134352,ENSG00000141741,ENSG00000160862,ENSG00000175793,ENSG00000242265,ENSG00000034510,ENSG00000186847,ENSG00000211897
ENSG00000104332,ENSG00000034510,ENSG00000123689,ENSG00000211896,ENSG00000251791,ENSG00000171560,ENSG00000101470,ENSG00000184009,ENSG00000166482,ENSG00000131771,ENSG00000112685,ENSG00000185885,ENSG00000137959,ENSG00000143320,ENSG00000155368,ENSG00000110492,ENSG00000110492,ENSG00000143320,ENSG00000118363,ENSG00000135346,ENSG00000197766,ENSG00000074410,ENSG00000211895,ENSG00000075624,ENSG00000211677,ENSG00000146476,ENSG00000196154,ENSG00000196754,ENSG00000211899
ENSG00000120129,ENSG00000112306,ENSG00000244734,ENSG00000198502,ENSG00000252481,ENSG00000110245,ENSG00000092054,ENSG00000103024,ENSG00000167676,ENSG00000148346,ENSG00000003989,ENSG00000176046,ENSG00000034510,ENSG00000034510,ENSG00000169919,ENSG00000175063,ENSG00000111716,ENSG00000075624,ENSG00000169245,ENSG00000109436,ENSG00000148180,ENSG00000172551,ENSG00000131771,ENSG00000114200,ENSG00000187608,ENSG00000126709,ENSG00000173432,ENSG00000143556,ENSG00000211892
ENSG00000112936,ENSG00000109062,ENSG00000175445,ENSG00000211772,ENSG00000259001,ENSG00000118137,ENSG00000125414,ENSG00000153002,ENSG00000211890,ENSG00000186832,ENSG00000160180,ENSG00000187608,ENSG00000197956,ENSG00000075624,ENSG00000134184,ENSG00000163923,ENSG00000181788,ENSG00000164919,ENSG00000211895,ENSG00000101210,ENSG00000121691,ENSG00000074527,ENSG00000148346,ENSG00000184009,ENSG00000198502,ENSG00000109436,ENSG00000104332,ENSG00000186081,ENSG00000254709
ENSG00000115461,ENSG00000111341,ENSG00000196616,ENSG00000268751,ENSG00000208772,ENSG00000218227,ENSG00000114854,ENSG00000109062,ENSG00000004799,ENSG00000175793,ENSG00000146476,ENSG00000160932,ENSG00000160932,ENSG00000172551,ENSG00000096088,ENSG00000107833,ENSG00000142173,ENSG00000141424,ENSG00000120738,ENSG00000163631,ENSG00000120129,ENSG00000181788,ENSG00000143320,ENSG00000179593,ENSG00000011600,ENSG00000169490,ENSG00000163017,ENSG00000143546,ENSG00000169442
ENSG00000211677,ENSG00000110492,ENSG00000167588,ENSG00000211895,ENSG00000112306,ENSG00000143536,ENSG00000130598,ENSG00000126709,ENSG00000105974,ENSG00000160213,ENSG00000160862,ENSG00000110092,ENSG00000111335,ENSG00000101439,ENSG00000134201,ENSG00000243678,ENSG00000211895,ENSG00000137331,ENSG00000142173,ENSG00000142875,ENSG00000095637,ENSG00000167768,ENSG00000132465,ENSG00000187097,ENSG00000172551,ENSG00000272335,ENSG00000160307,ENSG00000186395,ENSG00000105369
ENSG00000133392,ENSG00000233622,ENSG00000138207,ENSG00000090382,ENSG00000269900,ENSG00000158874,ENSG00000175084,ENSG00000075624,ENSG00000197766,ENSG00000188508,ENSG00000145824,ENSG00000075624,ENSG00000157601,ENSG00000135480,ENSG00000067064,ENSG00000104738,ENSG00000168743,ENSG00000123124,ENSG00000211897,ENSG00000108176,ENSG00000170345,ENSG00000124422,ENSG00000160180,ENSG00000172551,ENSG00000149273,ENSG00000156675,ENSG00000186081,ENSG00000186832,ENSG00000090382
ENSG00000142871,ENSG00000143632,ENSG00000143196,ENSG00000082074,ENSG00000184009,ENSG00000266469,ENSG00000180209,ENSG00000137331,ENSG00000143196,ENSG00000188505,ENSG00000189334,ENSG00000143387,ENSG00000068079,ENSG00000141424,ENSG00000183569,ENSG00000145824,ENSG00000112378,ENSG00000146476,ENSG00000154096,ENSG00000110092,ENSG00000196616,ENSG00000179456,ENSG00000118523,ENSG00000130203,ENSG00000143320,ENSG00000147548,ENSG00000211890,ENSG00000175793,ENSG00000172724
ENSG00000115963,ENSG00000075624,ENSG00000187288,ENSG00000105369,ENSG00000263740,ENSG00000105974,ENSG00000196091,ENSG00000130303,ENSG00000187288,ENSG00000118849,ENSG00000168743,ENSG00000211679,ENSG00000185745,ENSG00000188505,ENSG00000100031,ENSG00000137166,ENSG00000159212,ENSG00000159388,ENSG00000130635,ENSG00000183779,ENSG00000141424,ENSG00000163631,ENSG00000075624,ENSG00000104368,ENSG00000115461,ENSG00000168743,ENSG00000158887,ENSG00000178934,ENSG00000211895
ENSG00000182253,ENSG00000074410,ENSG00000135218,ENSG00000254709,ENSG00000168298,ENSG00000073605,ENSG00000170290,ENSG00000104267,ENSG00000123689,ENSG00000182853,ENSG00000034510,ENSG00000057663,ENSG00000185885,ENSG00000132688,ENSG00000269235,ENSG00000184009,ENSG00000135480,ENSG00000181788,ENSG00000185499,ENSG00000180573,ENSG00000143632,ENSG00000104447,ENSG00000157404,ENSG00000107438,ENSG00000197956,ENSG00000147471,ENSG00000155760,ENSG00000124102,ENSG00000173369
ENSG00000211899,ENSG00000104879,ENSG00000004776,ENSG00000132465,ENSG00000034510,ENSG00000185559,ENSG00000177791,ENSG00000246705,ENSG00000175445,ENSG00000167656,ENSG00000184009,ENSG00000145824,ENSG00000137309,ENSG00000133048,ENSG00000241720,ENSG00000163584,ENSG00000111341,ENSG00000111799,ENSG00000173369,ENSG00000214530,ENSG00000173432,ENSG00000126709,ENSG00000198832,ENSG00000142173,ENSG00000132465,ENSG00000112306,ENSG00000112306,ENSG00000203782,ENSG00000099958
ENSG00000126709,ENSG00000109472,ENSG00000197766,ENSG00000105374,ENSG00000075624,ENSG00000125144,ENSG00000239474,ENSG00000123124,ENSG00000120129,ENSG00000141736,ENSG00000158373,ENSG00000109436,ENSG00000115415,ENSG00000071967,ENSG00000135480,ENSG00000126709,ENSG00000118785,ENSG00000104267,ENSG00000173372,ENSG00000084444,ENSG00000163631,ENSG00000002834,ENSG00000266469,ENSG00000155093,ENSG00000189334,ENSG00000130303,ENSG00000148180,ENSG00000211679,ENSG00000130203
ENSG00000159388,ENSG00000160862,ENSG00000099194,ENSG00000160255,ENSG00000238795,ENSG00000197956,ENSG00000173991,ENSG00000008283,ENSG00000148180,ENSG00000196754,ENSG00000134352,ENSG00000108829,ENSG00000128228,ENSG00000197956,ENSG00000259479,ENSG00000180543,ENSG00000184009,ENSG00000105048,ENSG00000123836,ENSG00000187244,ENSG00000211890,ENSG00000131771,ENSG00000120738,ENSG00000197249,ENSG00000034510,ENSG00000143320,ENSG00000163661,ENSG00000188508,ENSG00000227507
ENSG00000122877,ENSG00000171236,ENSG00000079435,ENSG00000111341,ENSG00000108298,ENSG00000167258,ENSG00000196296,ENSG00000197249,ENSG00000135218,ENSG00000169429,ENSG00000138449,ENSG00000160862,ENSG00000211895,ENSG00000189334,ENSG00000158104,ENSG00000179967,ENSG00000142871,ENSG00000168743,ENSG00000109814,ENSG00000164125,ENSG00000198125,ENSG00000117632,ENSG00000113739,ENSG00000142156,ENSG00000211679,ENSG00000196177,ENSG00000165507,ENSG00000182853,ENSG00000231389
ENSG00000211893,ENSG00000211677,ENSG00000131471,ENSG00000007312,ENSG00000117984,ENSG00000171557,ENSG00000108515,ENSG00000142875,ENSG00000184557,ENSG00000205420,ENSG00000099953,ENSG00000117984,ENSG00000147804,ENSG00000178372,ENSG00000109929,ENSG00000165949,ENSG00000163631,ENSG00000128016,ENSG00000197956,ENSG00000151552,ENSG00000168497,ENSG00000156968,ENSG00000137077,ENSG00000268751,ENSG00000169245,ENSG00000185885,ENSG00000162998,ENSG00000167656,ENSG00000198502
ENSG00000187193,ENSG00000110092,ENSG00000105974,ENSG00000126353,ENSG00000197956,ENSG00000211677,ENSG00000077522,ENSG00000162910,ENSG00000011465,ENSG00000241794,ENSG00000197956,ENSG00000159189,ENSG00000187837,ENSG00000117115,ENSG00000115255,ENSG00000008517,ENSG00000074410,ENSG00000180573,ENSG00000105472,ENSG00000184678,ENSG00000130595,ENSG00000175899,ENSG00000211890,ENSG00000120875,ENSG00000211899,ENSG00000175324,ENSG00000156804,ENSG00000160213,ENSG00000102879
ENSG00000172236,ENSG00000160180,ENSG00000128016,ENSG00000211679,ENSG00000254911,ENSG00000111341,ENSG00000156885,ENSG00000187608,ENSG00000211445,ENSG00000111215,ENSG00000133195,ENSG00000211892,ENSG00000114631,ENSG00000126709,ENSG00000134716,ENSG00000117399,ENSG00000185499,ENSG00000110092,ENSG00000107438,ENSG00000109472,ENSG00000142871,ENSG00000143119,ENSG00000128016,ENSG00000165272,ENSG00000143387,ENSG00000155792,ENSG00000075618,ENSG00000118849,ENSG00000135916
