Topic 1,Topic 2,Topic 3,Topic 4,Topic 5,Topic 6,Topic 7,Topic 8,Topic 9,Topic 10,Topic 11,Topic 12,Topic 13,Topic 14,Topic 15,Topic 16,Topic 17,Topic 18,Topic 19,Topic 20,Topic 21,Topic 22,Topic 23,Topic 24,Topic 25,Topic 26,Topic 27,Topic 28,Topic 29,Topic 30,Topic 31,Topic 32,Topic 33,Topic 34,Topic 35,Topic 36,Topic 37,Topic 38,Topic 39,Topic 40,Topic 41,Topic 42,Topic 43,Topic 44,Topic 45,Topic 46,Topic 47,Topic 48,Topic 49,Topic 50,Topic 51,Topic 52,Topic 53,Topic 54,Topic 55,Topic 56,Topic 57,Topic 58,Topic 59,Topic 60,Topic 61,Topic 62,Topic 63,Topic 64,Topic 65,Topic 66,Topic 67,Topic 68,Topic 69,Topic 70,Topic 71,Topic 72,Topic 73,Topic 74,Topic 75,Topic 76,Topic 77,Topic 78,Topic 79
ENSG00000112306,ENSG00000189058,ENSG00000111341,ENSG00000211892,ENSG00000202198,ENSG00000108298,ENSG00000211895,ENSG00000184009,ENSG00000145824,ENSG00000163220,ENSG00000163220,ENSG00000211892,ENSG00000187608,ENSG00000124107,ENSG00000111341,ENSG00000034510,ENSG00000111341,ENSG00000143632,ENSG00000075624,ENSG00000111341,ENSG00000120738,ENSG00000159763,ENSG00000189058,ENSG00000160180,ENSG00000211896,ENSG00000211895,ENSG00000163017,ENSG00000153002,ENSG00000211896,ENSG00000211895,ENSG00000202198,ENSG00000159763,ENSG00000129437,ENSG00000211895,ENSG00000108298,ENSG00000110092,ENSG00000109436,ENSG00000100985,ENSG00000034510,ENSG00000202198,ENSG00000111341,ENSG00000160180,ENSG00000108298,ENSG00000163220,ENSG00000115461,ENSG00000112306,ENSG00000141424,ENSG00000211899,ENSG00000170323,ENSG00000202198,ENSG00000202198,ENSG00000111341,ENSG00000169710,ENSG00000170345,ENSG00000117984,ENSG00000034510,ENSG00000169245,ENSG00000145824,ENSG00000102837,ENSG00000125148,ENSG00000189058,ENSG00000187608,ENSG00000034510,ENSG00000100985,ENSG00000172551,ENSG00000109062,ENSG00000186847,ENSG00000163631,ENSG00000141424,ENSG00000211895,ENSG00000113739,ENSG00000141424,ENSG00000167768,ENSG00000211892,ENSG00000099953,ENSG00000142871,ENSG00000187608,ENSG00000117984,ENSG00000171560
ENSG00000138449,ENSG00000116752,ENSG00000198502,ENSG00000211896,ENSG00000212443,ENSG00000266469,ENSG00000211890,ENSG00000126709,ENSG00000138449,ENSG00000143556,ENSG00000245910,ENSG00000169442,ENSG00000126709,ENSG00000111215,ENSG00000211895,ENSG00000111716,ENSG00000034510,ENSG00000104879,ENSG00000165795,ENSG00000110092,ENSG00000111341,ENSG00000161634,ENSG00000179593,ENSG00000034510,ENSG00000211677,ENSG00000185499,ENSG00000186847,ENSG00000160180,ENSG00000211677,ENSG00000090382,ENSG00000200087,ENSG00000161634,ENSG00000149273,ENSG00000211890,ENSG00000141741,ENSG00000034510,ENSG00000168461,ENSG00000112306,ENSG00000184009,ENSG00000212232,ENSG00000197956,ENSG00000099953,ENSG00000211895,ENSG00000163631,ENSG00000189058,ENSG00000141424,ENSG00000211895,ENSG00000163220,ENSG00000173432,ENSG00000200087,ENSG00000038427,ENSG00000112306,ENSG00000159763,ENSG00000118523,ENSG00000164919,ENSG00000075624,ENSG00000197956,ENSG00000153002,ENSG00000171564,ENSG00000113296,ENSG00000211896,ENSG00000185885,ENSG00000108298,ENSG00000102575,ENSG00000189058,ENSG00000126709,ENSG00000196754,ENSG00000013583,ENSG00000153002,ENSG00000034510,ENSG00000141424,ENSG00000143320,ENSG00000188508,ENSG00000163017,ENSG00000101210,ENSG00000147465,ENSG00000126709,ENSG00000184009,ENSG00000132693
ENSG00000225972,ENSG00000211896,ENSG00000141736,ENSG00000211895,ENSG00000252481,ENSG00000125686,ENSG00000142871,ENSG00000160180,ENSG00000161634,ENSG00000143546,ENSG00000143546,ENSG00000211896,ENSG00000165949,ENSG00000118849,ENSG00000159763,ENSG00000112306,ENSG00000145824,ENSG00000111245,ENSG00000175899,ENSG00000123124,ENSG00000197956,ENSG00000089199,ENSG00000171564,ENSG00000120885,ENSG00000211897,ENSG00000141424,ENSG00000157404,ENSG00000117472,ENSG00000211893,ENSG00000116285,ENSG00000212232,ENSG00000034510,ENSG00000225972,ENSG00000132465,ENSG00000266469,ENSG00000111341,ENSG00000164919,ENSG00000111341,ENSG00000211895,ENSG00000034510,ENSG00000149273,ENSG00000115461,ENSG00000130203,ENSG00000229314,ENSG00000172551,ENSG00000233622,ENSG00000198832,ENSG00000102837,ENSG00000167676,ENSG00000245532,ENSG00000126709,ENSG00000177606,ENSG00000189058,ENSG00000183722,ENSG00000141424,ENSG00000169439,ENSG00000143632,ENSG00000160180,ENSG00000034510,ENSG00000111341,ENSG00000211677,ENSG00000130303,ENSG00000131748,ENSG00000142156,ENSG00000179593,ENSG00000187608,ENSG00000186081,ENSG00000183779,ENSG00000186395,ENSG00000011028,ENSG00000152661,ENSG00000233622,ENSG00000203782,ENSG00000084207,ENSG00000167900,ENSG00000140459,ENSG00000184009,ENSG00000104341,ENSG00000171564
ENSG00000034510,ENSG00000143632,ENSG00000123358,ENSG00000129437,ENSG00000212232,ENSG00000141736,ENSG00000132465,ENSG00000125144,ENSG00000115461,ENSG00000205420,ENSG00000075624,ENSG00000206503,ENSG00000068079,ENSG00000124102,ENSG00000105894,ENSG00000186832,ENSG00000173372,ENSG00000168530,ENSG00000197956,ENSG00000197249,ENSG00000169908,ENSG00000100604,ENSG00000034510,ENSG00000159388,ENSG00000211679,ENSG00000126709,ENSG00000112306,ENSG00000135346,ENSG00000211679,ENSG00000178531,ENSG00000034510,ENSG00000197249,ENSG00000118849,ENSG00000162896,ENSG00000172057,ENSG00000126709,ENSG00000156675,ENSG00000142173,ENSG00000117984,ENSG00000075624,ENSG00000211677,ENSG00000187837,ENSG00000111341,ENSG00000143546,ENSG00000169908,ENSG00000152137,ENSG00000126709,ENSG00000143546,ENSG00000166819,ENSG00000146648,ENSG00000200087,ENSG00000149273,ENSG00000141424,ENSG00000091986,ENSG00000153002,ENSG00000112306,ENSG00000226278,ENSG00000112685,ENSG00000257017,ENSG00000184009,ENSG00000225972,ENSG00000126709,ENSG00000111341,ENSG00000142173,ENSG00000160862,ENSG00000183779,ENSG00000197956,ENSG00000160180,ENSG00000167768,ENSG00000112306,ENSG00000183779,ENSG00000146476,ENSG00000178934,ENSG00000211679,ENSG00000187837,ENSG00000166482,ENSG00000211679,ENSG00000200087,ENSG00000158874
ENSG00000142156,ENSG00000211897,ENSG00000152661,ENSG00000172724,ENSG00000251791,ENSG00000141741,ENSG00000120129,ENSG00000108298,ENSG00000167549,ENSG00000131771,ENSG00000187840,ENSG00000268751,ENSG00000185745,ENSG00000148346,ENSG00000171346,ENSG00000178372,ENSG00000107438,ENSG00000101470,ENSG00000134352,ENSG00000074201,ENSG00000138207,ENSG00000160862,ENSG00000269235,ENSG00000117984,ENSG00000169442,ENSG00000160862,ENSG00000105894,ENSG00000142875,ENSG00000211897,ENSG00000211677,ENSG00000112306,ENSG00000114200,ENSG00000160862,ENSG00000137077,ENSG00000161395,ENSG00000211677,ENSG00000131844,ENSG00000102575,ENSG00000147862,ENSG00000269900,ENSG00000196091,ENSG00000211679,ENSG00000189058,ENSG00000135245,ENSG00000075624,ENSG00000183779,ENSG00000160862,ENSG00000143556,ENSG00000211445,ENSG00000212232,ENSG00000034510,ENSG00000126709,ENSG00000125995,ENSG00000112936,ENSG00000187837,ENSG00000130303,ENSG00000211893,ENSG00000152661,ENSG00000124102,ENSG00000079739,ENSG00000186847,ENSG00000165949,ENSG00000173457,ENSG00000106333,ENSG00000204936,ENSG00000125730,ENSG00000170477,ENSG00000084444,ENSG00000188508,ENSG00000011465,ENSG00000196562,ENSG00000109062,ENSG00000186847,ENSG00000211896,ENSG00000160862,ENSG00000105894,ENSG00000034510,ENSG00000034510,ENSG00000125144
ENSG00000172197,ENSG00000183386,ENSG00000105894,ENSG00000211677,ENSG00000034510,ENSG00000131771,ENSG00000118523,ENSG00000034510,ENSG00000106688,ENSG00000124102,ENSG00000117984,ENSG00000211893,ENSG00000133321,ENSG00000182853,ENSG00000104267,ENSG00000107833,ENSG00000160180,ENSG00000125414,ENSG00000184009,ENSG00000149269,ENSG00000148180,ENSG00000172551,ENSG00000108298,ENSG00000126709,ENSG00000211893,ENSG00000115461,ENSG00000182253,ENSG00000101210,ENSG00000211899,ENSG00000163513,ENSG00000168298,ENSG00000071967,ENSG00000211899,ENSG00000104332,ENSG00000141736,ENSG00000175899,ENSG00000112996,ENSG00000206503,ENSG00000189058,ENSG00000168298,ENSG00000164919,ENSG00000211895,ENSG00000129103,ENSG00000143556,ENSG00000159763,ENSG00000164919,ENSG00000160888,ENSG00000182853,ENSG00000175445,ENSG00000238741,ENSG00000212232,ENSG00000171346,ENSG00000109062,ENSG00000142173,ENSG00000115255,ENSG00000187837,ENSG00000112306,ENSG00000183779,ENSG00000163220,ENSG00000117479,ENSG00000233622,ENSG00000101443,ENSG00000178372,ENSG00000142552,ENSG00000155368,ENSG00000185745,ENSG00000175793,ENSG00000147535,ENSG00000099194,ENSG00000106333,ENSG00000110092,ENSG00000115461,ENSG00000244617,ENSG00000117984,ENSG00000155906,ENSG00000180914,ENSG00000065809,ENSG00000104549,ENSG00000171557
ENSG00000139211,ENSG00000211892,ENSG00000024422,ENSG00000211893,ENSG00000263740,ENSG00000108344,ENSG00000128016,ENSG00000106927,ENSG00000145632,ENSG00000169469,ENSG00000111341,ENSG00000132465,ENSG00000119922,ENSG00000172551,ENSG00000183569,ENSG00000235174,ENSG00000138449,ENSG00000198125,ENSG00000174276,ENSG00000144218,ENSG00000100985,ENSG00000187097,ENSG00000096088,ENSG00000159763,ENSG00000034510,ENSG00000136997,ENSG00000173432,ENSG00000126709,ENSG00000211892,ENSG00000186847,ENSG00000251791,ENSG00000173369,ENSG00000173369,ENSG00000213088,ENSG00000125686,ENSG00000120885,ENSG00000158373,ENSG00000117632,ENSG00000109062,ENSG00000251791,ENSG00000211895,ENSG00000118523,ENSG00000126709,ENSG00000034510,ENSG00000105894,ENSG00000111341,ENSG00000225972,ENSG00000211893,ENSG00000123689,ENSG00000252481,ENSG00000104341,ENSG00000182013,ENSG00000136436,ENSG00000107796,ENSG00000109062,ENSG00000156804,ENSG00000105048,ENSG00000084444,ENSG00000229314,ENSG00000159189,ENSG00000160888,ENSG00000133321,ENSG00000106565,ENSG00000166165,ENSG00000169919,ENSG00000185885,ENSG00000075618,ENSG00000135346,ENSG00000143369,ENSG00000187608,ENSG00000168461,ENSG00000163631,ENSG00000186395,ENSG00000172724,ENSG00000211896,ENSG00000157404,ENSG00000109062,ENSG00000197956,ENSG00000110245
ENSG00000120885,ENSG00000162576,ENSG00000147813,ENSG00000173369,ENSG00000255823,ENSG00000002834,ENSG00000120738,ENSG00000141736,ENSG00000109436,ENSG00000160213,ENSG00000167656,ENSG00000211679,ENSG00000185885,ENSG00000133048,ENSG00000124107,ENSG00000163584,ENSG00000196205,ENSG00000092054,ENSG00000242574,ENSG00000112306,ENSG00000145824,ENSG00000114200,ENSG00000095321,ENSG00000109062,ENSG00000105369,ENSG00000145824,ENSG00000152284,ENSG00000187244,ENSG00000254709,ENSG00000137077,ENSG00000075624,ENSG00000012660,ENSG00000143119,ENSG00000142871,ENSG00000218227,ENSG00000089127,ENSG00000159212,ENSG00000120738,ENSG00000166819,ENSG00000197956,ENSG00000034510,ENSG00000147677,ENSG00000002834,ENSG00000115461,ENSG00000185499,ENSG00000185499,ENSG00000075624,ENSG00000118849,ENSG00000196616,ENSG00000062716,ENSG00000070018,ENSG00000211895,ENSG00000008283,ENSG00000104332,ENSG00000214530,ENSG00000175899,ENSG00000237649,ENSG00000141367,ENSG00000184009,ENSG00000187837,ENSG00000143320,ENSG00000185745,ENSG00000178531,ENSG00000138080,ENSG00000183569,ENSG00000173267,ENSG00000205420,ENSG00000175324,ENSG00000203782,ENSG00000099194,ENSG00000109436,ENSG00000108932,ENSG00000172867,ENSG00000148346,ENSG00000143320,ENSG00000170345,ENSG00000211893,ENSG00000141424,ENSG00000118137
ENSG00000171812,ENSG00000049540,ENSG00000116729,ENSG00000090382,ENSG00000184260,ENSG00000167258,ENSG00000064300,ENSG00000173432,ENSG00000130635,ENSG00000189001,ENSG00000163209,ENSG00000130208,ENSG00000206503,ENSG00000163975,ENSG00000099194,ENSG00000010292,ENSG00000108298,ENSG00000114854,ENSG00000084207,ENSG00000197956,ENSG00000116133,ENSG00000183569,ENSG00000115461,ENSG00000160862,ENSG00000169245,ENSG00000112655,ENSG00000109846,ENSG00000105290,ENSG00000105369,ENSG00000186081,ENSG00000212443,ENSG00000122176,ENSG00000202198,ENSG00000171346,ENSG00000131771,ENSG00000125148,ENSG00000109062,ENSG00000197956,ENSG00000137077,ENSG00000212443,ENSG00000206503,ENSG00000140403,ENSG00000131771,ENSG00000111716,ENSG00000134013,ENSG00000145824,ENSG00000187608,ENSG00000090382,ENSG00000167588,ENSG00000111799,ENSG00000142798,ENSG00000108298,ENSG00000149150,ENSG00000004799,ENSG00000159763,ENSG00000149257,ENSG00000128016,ENSG00000147535,ENSG00000211895,ENSG00000141424,ENSG00000115461,ENSG00000117984,ENSG00000141736,ENSG00000143387,ENSG00000096088,ENSG00000164919,ENSG00000129194,ENSG00000186480,ENSG00000185745,ENSG00000162896,ENSG00000187244,ENSG00000124171,ENSG00000175793,ENSG00000178372,ENSG00000120885,ENSG00000120738,ENSG00000200087,ENSG00000113739,ENSG00000257017
ENSG00000136379,ENSG00000090104,ENSG00000135842,ENSG00000121966,ENSG00000208772,ENSG00000218227,ENSG00000107796,ENSG00000185499,ENSG00000159763,ENSG00000124107,ENSG00000143556,ENSG00000090382,ENSG00000176046,ENSG00000104783,ENSG00000128016,ENSG00000169442,ENSG00000185499,ENSG00000180209,ENSG00000173432,ENSG00000087884,ENSG00000130176,ENSG00000071967,ENSG00000096060,ENSG00000104763,ENSG00000254709,ENSG00000034510,ENSG00000143196,ENSG00000150687,ENSG00000099958,ENSG00000163563,ENSG00000111341,ENSG00000112796,ENSG00000130303,ENSG00000112306,ENSG00000073605,ENSG00000197956,ENSG00000110092,ENSG00000130303,ENSG00000186340,ENSG00000252481,ENSG00000143632,ENSG00000126709,ENSG00000197956,ENSG00000112306,ENSG00000169692,ENSG00000006831,ENSG00000183779,ENSG00000167656,ENSG00000244734,ENSG00000229152,ENSG00000245532,ENSG00000235552,ENSG00000160862,ENSG00000163520,ENSG00000189058,ENSG00000104763,ENSG00000159388,ENSG00000132639,ENSG00000124107,ENSG00000099194,ENSG00000108298,ENSG00000225972,ENSG00000160862,ENSG00000118785,ENSG00000134184,ENSG00000034510,ENSG00000186832,ENSG00000100604,ENSG00000158373,ENSG00000137309,ENSG00000140443,ENSG00000084444,ENSG00000169509,ENSG00000132465,ENSG00000109062,ENSG00000130176,ENSG00000104894,ENSG00000189334,ENSG00000205364
ENSG00000154473,ENSG00000175084,ENSG00000142173,ENSG00000227507,ENSG00000238741,ENSG00000188895,ENSG00000006210,ENSG00000112306,ENSG00000143387,ENSG00000196754,ENSG00000206503,ENSG00000211899,ENSG00000034510,ENSG00000134802,ENSG00000115461,ENSG00000249992,ENSG00000206503,ENSG00000130598,ENSG00000122862,ENSG00000113739,ENSG00000143320,ENSG00000179593,ENSG00000171557,ENSG00000197249,ENSG00000206503,ENSG00000164125,ENSG00000073756,ENSG00000164125,ENSG00000169442,ENSG00000173372,ENSG00000252481,ENSG00000105202,ENSG00000189334,ENSG00000166482,ENSG00000008838,ENSG00000159763,ENSG00000143320,ENSG00000175063,ENSG00000211677,ENSG00000202058,ENSG00000132465,ENSG00000120885,ENSG00000142156,ENSG00000171557,ENSG00000118785,ENSG00000169710,ENSG00000013583,ENSG00000211897,ENSG00000187288,ENSG00000254198,ENSG00000125148,ENSG00000006210,ENSG00000187608,ENSG00000163431,ENSG00000075886,ENSG00000135480,ENSG00000176890,ENSG00000141424,ENSG00000141424,ENSG00000100979,ENSG00000177606,ENSG00000138642,ENSG00000244398,ENSG00000149257,ENSG00000100031,ENSG00000132329,ENSG00000081277,ENSG00000138821,ENSG00000109062,ENSG00000137077,ENSG00000138449,ENSG00000155906,ENSG00000143320,ENSG00000109846,ENSG00000162482,ENSG00000136859,ENSG00000108344,ENSG00000104447,ENSG00000091583
ENSG00000008441,ENSG00000196091,ENSG00000142871,ENSG00000169442,ENSG00000168298,ENSG00000073605,ENSG00000171346,ENSG00000141424,ENSG00000186340,ENSG00000034510,ENSG00000140105,ENSG00000168394,ENSG00000159388,ENSG00000104332,ENSG00000176845,ENSG00000175063,ENSG00000211895,ENSG00000196091,ENSG00000118363,ENSG00000116133,ENSG00000108826,ENSG00000169347,ENSG00000169919,ENSG00000136770,ENSG00000227507,ENSG00000110799,ENSG00000132561,ENSG00000140526,ENSG00000135916,ENSG00000163131,ENSG00000147677,ENSG00000157303,ENSG00000211677,ENSG00000161055,ENSG00000131748,ENSG00000122862,ENSG00000106688,ENSG00000123975,ENSG00000121898,ENSG00000169908,ENSG00000011465,ENSG00000100985,ENSG00000159399,ENSG00000169245,ENSG00000268751,ENSG00000168743,ENSG00000171428,ENSG00000124102,ENSG00000138207,ENSG00000212443,ENSG00000180573,ENSG00000224631,ENSG00000169738,ENSG00000180914,ENSG00000117472,ENSG00000162337,ENSG00000177791,ENSG00000143320,ENSG00000118137,ENSG00000124126,ENSG00000214078,ENSG00000115415,ENSG00000166482,ENSG00000117385,ENSG00000135480,ENSG00000187837,ENSG00000183036,ENSG00000149269,ENSG00000034510,ENSG00000178372,ENSG00000196177,ENSG00000148154,ENSG00000186081,ENSG00000064886,ENSG00000066583,ENSG00000184557,ENSG00000122176,ENSG00000202198,ENSG00000229314
ENSG00000206503,ENSG00000211899,ENSG00000161544,ENSG00000160255,ENSG00000175899,ENSG00000108349,ENSG00000123358,ENSG00000174807,ENSG00000179456,ENSG00000188508,ENSG00000034510,ENSG00000162692,ENSG00000160862,ENSG00000102837,ENSG00000233762,ENSG00000149273,ENSG00000160932,ENSG00000170290,ENSG00000160180,ENSG00000141232,ENSG00000107438,ENSG00000143248,ENSG00000172551,ENSG00000152661,ENSG00000211899,ENSG00000184009,ENSG00000188783,ENSG00000197457,ENSG00000130203,ENSG00000102760,ENSG00000263740,ENSG00000187097,ENSG00000211897,ENSG00000011465,ENSG00000108306,ENSG00000112306,ENSG00000104447,ENSG00000143320,ENSG00000136235,ENSG00000263740,ENSG00000171222,ENSG00000211896,ENSG00000142871,ENSG00000111341,ENSG00000142156,ENSG00000143320,ENSG00000196205,ENSG00000148346,ENSG00000143196,ENSG00000251791,ENSG00000263740,ENSG00000182253,ENSG00000075886,ENSG00000173432,ENSG00000246705,ENSG00000123975,ENSG00000187608,ENSG00000108176,ENSG00000158874,ENSG00000143387,ENSG00000075624,ENSG00000135114,ENSG00000160180,ENSG00000242252,ENSG00000156968,ENSG00000121316,ENSG00000155380,ENSG00000146476,ENSG00000198794,ENSG00000091409,ENSG00000075624,ENSG00000132329,ENSG00000167656,ENSG00000211893,ENSG00000260260,ENSG00000269936,ENSG00000252481,ENSG00000242265,ENSG00000105697
ENSG00000181788,ENSG00000100985,ENSG00000159212,ENSG00000198502,ENSG00000075624,ENSG00000131748,ENSG00000162772,ENSG00000160862,ENSG00000160862,ENSG00000165474,ENSG00000167779,ENSG00000179344,ENSG00000229119,ENSG00000083444,ENSG00000120885,ENSG00000117632,ENSG00000159212,ENSG00000175084,ENSG00000092758,ENSG00000146476,ENSG00000186847,ENSG00000120885,ENSG00000204936,ENSG00000143320,ENSG00000102879,ENSG00000129437,ENSG00000158887,ENSG00000136457,ENSG00000090382,ENSG00000211899,ENSG00000238795,ENSG00000134020,ENSG00000143320,ENSG00000180914,ENSG00000034510,ENSG00000124107,ENSG00000141424,ENSG00000075624,ENSG00000135052,ENSG00000160862,ENSG00000188290,ENSG00000075624,ENSG00000166278,ENSG00000211895,ENSG00000214530,ENSG00000197457,ENSG00000110492,ENSG00000211895,ENSG00000170345,ENSG00000255823,ENSG00000238795,ENSG00000166025,ENSG00000163536,ENSG00000162444,ENSG00000101443,ENSG00000234614,ENSG00000141424,ENSG00000109062,ENSG00000115461,ENSG00000157303,ENSG00000164403,ENSG00000079462,ENSG00000181218,ENSG00000159674,ENSG00000067064,ENSG00000175793,ENSG00000196878,ENSG00000156735,ENSG00000008441,ENSG00000198380,ENSG00000160180,ENSG00000104341,ENSG00000124107,ENSG00000211890,ENSG00000110092,ENSG00000118523,ENSG00000143578,ENSG00000130203,ENSG00000135744
ENSG00000143320,ENSG00000196296,ENSG00000117399,ENSG00000211897,ENSG00000142173,ENSG00000197956,ENSG00000236439,ENSG00000152661,ENSG00000145569,ENSG00000241794,ENSG00000165474,ENSG00000211895,ENSG00000157601,ENSG00000092621,ENSG00000211890,ENSG00000130303,ENSG00000163993,ENSG00000239474,ENSG00000076706,ENSG00000126709,ENSG00000196878,ENSG00000107438,ENSG00000197956,ENSG00000211895,ENSG00000173894,ENSG00000108298,ENSG00000156804,ENSG00000112562,ENSG00000130208,ENSG00000136826,ENSG00000164919,ENSG00000115641,ENSG00000197956,ENSG00000133392,ENSG00000143536,ENSG00000104447,ENSG00000138449,ENSG00000189334,ENSG00000090382,ENSG00000112306,ENSG00000169692,ENSG00000164919,ENSG00000116133,ENSG00000146731,ENSG00000011260,ENSG00000130635,ENSG00000066583,ENSG00000211896,ENSG00000197766,ENSG00000208772,ENSG00000197714,ENSG00000179862,ENSG00000142694,ENSG00000211445,ENSG00000112685,ENSG00000233622,ENSG00000196154,ENSG00000180573,ENSG00000143546,ENSG00000171346,ENSG00000117479,ENSG00000159763,ENSG00000108344,ENSG00000034510,ENSG00000158104,ENSG00000141424,ENSG00000167656,ENSG00000174080,ENSG00000211677,ENSG00000109436,ENSG00000272335,ENSG00000143369,ENSG00000104332,ENSG00000185633,ENSG00000025708,ENSG00000177606,ENSG00000206503,ENSG00000117228,ENSG00000176919
ENSG00000116133,ENSG00000211679,ENSG00000152137,ENSG00000168394,ENSG00000199477,ENSG00000161395,ENSG00000013297,ENSG00000104763,ENSG00000169347,ENSG00000112378,ENSG00000124107,ENSG00000102879,ENSG00000135114,ENSG00000140519,ENSG00000140545,ENSG00000025708,ENSG00000115461,ENSG00000077522,ENSG00000109846,ENSG00000211895,ENSG00000105974,ENSG00000012660,ENSG00000161634,ENSG00000211679,ENSG00000172724,ENSG00000112306,ENSG00000172201,ENSG00000137331,ENSG00000115415,ENSG00000024422,ENSG00000197714,ENSG00000164764,ENSG00000115461,ENSG00000125730,ENSG00000143753,ENSG00000196405,ENSG00000164125,ENSG00000160781,ENSG00000242265,ENSG00000074181,ENSG00000128311,ENSG00000099194,ENSG00000244734,ENSG00000118785,ENSG00000111341,ENSG00000075624,ENSG00000151458,ENSG00000140519,ENSG00000135218,ENSG00000233098,ENSG00000208772,ENSG00000105894,ENSG00000101210,ENSG00000105894,ENSG00000184678,ENSG00000211893,ENSG00000160862,ENSG00000168993,ENSG00000260549,ENSG00000189058,ENSG00000172551,ENSG00000132329,ENSG00000110492,ENSG00000154096,ENSG00000134201,ENSG00000141367,ENSG00000084207,ENSG00000187837,ENSG00000233622,ENSG00000242252,ENSG00000181788,ENSG00000122679,ENSG00000264281,ENSG00000135069,ENSG00000105974,ENSG00000134531,ENSG00000203875,ENSG00000140443,ENSG00000118520
ENSG00000189058,ENSG00000104879,ENSG00000188483,ENSG00000179344,ENSG00000225630,ENSG00000143536,ENSG00000211677,ENSG00000159388,ENSG00000104763,ENSG00000203785,ENSG00000103257,ENSG00000198502,ENSG00000143320,ENSG00000116741,ENSG00000160862,ENSG00000163923,ENSG00000186940,ENSG00000177791,ENSG00000118523,ENSG00000169347,ENSG00000120129,ENSG00000185499,ENSG00000172057,ENSG00000095321,ENSG00000068831,ENSG00000117984,ENSG00000104332,ENSG00000109472,ENSG00000105374,ENSG00000211890,ENSG00000130303,ENSG00000211677,ENSG00000149257,ENSG00000165795,ENSG00000174721,ENSG00000117984,ENSG00000157303,ENSG00000169583,ENSG00000163131,ENSG00000159388,ENSG00000135046,ENSG00000143369,ENSG00000107796,ENSG00000211677,ENSG00000129009,ENSG00000139629,ENSG00000011465,ENSG00000188505,ENSG00000105974,ENSG00000092969,ENSG00000129437,ENSG00000104332,ENSG00000034510,ENSG00000125740,ENSG00000197249,ENSG00000206503,ENSG00000185482,ENSG00000110092,ENSG00000186081,ENSG00000127995,ENSG00000112306,ENSG00000134321,ENSG00000170017,ENSG00000204044,ENSG00000162882,ENSG00000075624,ENSG00000161249,ENSG00000180694,ENSG00000100604,ENSG00000071967,ENSG00000104267,ENSG00000235978,ENSG00000189001,ENSG00000054598,ENSG00000186847,ENSG00000122877,ENSG00000134321,ENSG00000208772,ENSG00000106927
ENSG00000080573,ENSG00000113739,ENSG00000119938,ENSG00000169245,ENSG00000116133,ENSG00000160867,ENSG00000189129,ENSG00000143320,ENSG00000104267,ENSG00000118849,ENSG00000008394,ENSG00000211897,ENSG00000173193,ENSG00000178372,ENSG00000132465,ENSG00000168209,ENSG00000074410,ENSG00000196296,ENSG00000108298,ENSG00000077782,ENSG00000136997,ENSG00000129167,ENSG00000161395,ENSG00000171428,ENSG00000137309,ENSG00000134057,ENSG00000196754,ENSG00000141424,ENSG00000231389,ENSG00000175061,ENSG00000169710,ENSG00000164403,ENSG00000159423,ENSG00000162407,ENSG00000118271,ENSG00000142173,ENSG00000152661,ENSG00000126709,ENSG00000110092,ENSG00000173334,ENSG00000118785,ENSG00000189334,ENSG00000173992,ENSG00000099194,ENSG00000159388,ENSG00000159399,ENSG00000152661,ENSG00000169474,ENSG00000128016,ENSG00000224543,ENSG00000201302,ENSG00000155792,ENSG00000126709,ENSG00000140459,ENSG00000211677,ENSG00000211892,ENSG00000104951,ENSG00000196396,ENSG00000188257,ENSG00000183779,ENSG00000117385,ENSG00000109062,ENSG00000067064,ENSG00000198467,ENSG00000159763,ENSG00000084444,ENSG00000073111,ENSG00000134202,ENSG00000143320,ENSG00000158373,ENSG00000099953,ENSG00000175895,ENSG00000168490,ENSG00000196154,ENSG00000180694,ENSG00000107562,ENSG00000173372,ENSG00000110092,ENSG00000198417
ENSG00000211893,ENSG00000142156,ENSG00000142694,ENSG00000100342,ENSG00000118523,ENSG00000185559,ENSG00000104332,ENSG00000076604,ENSG00000074527,ENSG00000167656,ENSG00000116133,ENSG00000112306,ENSG00000129437,ENSG00000104140,ENSG00000134352,ENSG00000172216,ENSG00000164919,ENSG00000173991,ENSG00000126709,ENSG00000117984,ENSG00000115461,ENSG00000268751,ENSG00000131844,ENSG00000131844,ENSG00000211892,ENSG00000062716,ENSG00000267519,ENSG00000107262,ENSG00000051523,ENSG00000148180,ENSG00000184009,ENSG00000160180,ENSG00000111341,ENSG00000269936,ENSG00000108344,ENSG00000104341,ENSG00000075624,ENSG00000229314,ENSG00000132465,ENSG00000200087,ENSG00000160180,ENSG00000110092,ENSG00000026508,ENSG00000064886,ENSG00000134184,ENSG00000108349,ENSG00000092068,ENSG00000205420,ENSG00000131471,ENSG00000124422,ENSG00000254911,ENSG00000074219,ENSG00000135549,ENSG00000127990,ENSG00000174827,ENSG00000105619,ENSG00000090382,ENSG00000006831,ENSG00000118849,ENSG00000012660,ENSG00000123124,ENSG00000105048,ENSG00000142156,ENSG00000162576,ENSG00000241720,ENSG00000141232,ENSG00000109846,ENSG00000156675,ENSG00000109814,ENSG00000117984,ENSG00000150667,ENSG00000013588,ENSG00000169469,ENSG00000143320,ENSG00000068078,ENSG00000011465,ENSG00000202198,ENSG00000075624,ENSG00000173432
ENSG00000211455,ENSG00000225972,ENSG00000008394,ENSG00000268751,ENSG00000112306,ENSG00000111341,ENSG00000168878,ENSG00000117399,ENSG00000143507,ENSG00000175793,ENSG00000164611,ENSG00000180353,ENSG00000109062,ENSG00000079385,ENSG00000101210,ENSG00000106333,ENSG00000130303,ENSG00000129170,ENSG00000117984,ENSG00000075624,ENSG00000133048,ENSG00000095321,ENSG00000129521,ENSG00000130222,ENSG00000160255,ENSG00000132465,ENSG00000243955,ENSG00000114631,ENSG00000139193,ENSG00000127951,ENSG00000184260,ENSG00000141424,ENSG00000206503,ENSG00000159200,ENSG00000171475,ENSG00000113368,ENSG00000145824,ENSG00000125144,ENSG00000164330,ENSG00000198502,ENSG00000173372,ENSG00000141232,ENSG00000167900,ENSG00000143401,ENSG00000084207,ENSG00000104381,ENSG00000034510,ENSG00000241794,ENSG00000120738,ENSG00000117984,ENSG00000252481,ENSG00000187608,ENSG00000135480,ENSG00000163513,ENSG00000142694,ENSG00000117984,ENSG00000211892,ENSG00000113739,ENSG00000111341,ENSG00000101443,ENSG00000179593,ENSG00000089127,ENSG00000103490,ENSG00000129538,ENSG00000151726,ENSG00000062716,ENSG00000165474,ENSG00000139547,ENSG00000169710,ENSG00000160180,ENSG00000108176,ENSG00000104447,ENSG00000161249,ENSG00000211772,ENSG00000214530,ENSG00000170323,ENSG00000117228,ENSG00000123124,ENSG00000175567
ENSG00000196754,ENSG00000109062,ENSG00000211896,ENSG00000211679,ENSG00000002834,ENSG00000106333,ENSG00000254709,ENSG00000003989,ENSG00000228314,ENSG00000169474,ENSG00000149273,ENSG00000135916,ENSG00000178372,ENSG00000186081,ENSG00000185499,ENSG00000196154,ENSG00000179862,ENSG00000143318,ENSG00000162654,ENSG00000153002,ENSG00000186081,ENSG00000134020,ENSG00000206503,ENSG00000179456,ENSG00000143119,ENSG00000076924,ENSG00000197956,ENSG00000138434,ENSG00000206503,ENSG00000110492,ENSG00000041982,ENSG00000090382,ENSG00000125730,ENSG00000186847,ENSG00000178307,ENSG00000101210,ENSG00000180573,ENSG00000160213,ENSG00000004776,ENSG00000115415,ENSG00000160862,ENSG00000141424,ENSG00000115461,ENSG00000113296,ENSG00000147684,ENSG00000137331,ENSG00000142156,ENSG00000130707,ENSG00000099194,ENSG00000127914,ENSG00000139044,ENSG00000130176,ENSG00000211679,ENSG00000129103,ENSG00000211895,ENSG00000235162,ENSG00000198125,ENSG00000109436,ENSG00000133048,ENSG00000104368,ENSG00000145824,ENSG00000105619,ENSG00000172551,ENSG00000196154,ENSG00000269235,ENSG00000100304,ENSG00000178372,ENSG00000147471,ENSG00000108551,ENSG00000101443,ENSG00000180573,ENSG00000068078,ENSG00000108602,ENSG00000130203,ENSG00000100304,ENSG00000163431,ENSG00000099194,ENSG00000206503,ENSG00000141505
