Topic 1,Topic 2,Topic 3,Topic 4,Topic 5,Topic 6,Topic 7,Topic 8,Topic 9,Topic 10,Topic 11,Topic 12,Topic 13,Topic 14,Topic 15,Topic 16,Topic 17,Topic 18,Topic 19,Topic 20,Topic 21,Topic 22,Topic 23,Topic 24,Topic 25,Topic 26,Topic 27,Topic 28,Topic 29,Topic 30,Topic 31,Topic 32,Topic 33,Topic 34,Topic 35,Topic 36,Topic 37,Topic 38,Topic 39,Topic 40,Topic 41,Topic 42,Topic 43,Topic 44,Topic 45,Topic 46,Topic 47,Topic 48,Topic 49,Topic 50
ENSG00000186847,ENSG00000034510,ENSG00000170323,ENSG00000225972,ENSG00000202198,ENSG00000108298,ENSG00000211895,ENSG00000126709,ENSG00000145824,ENSG00000163220,ENSG00000153714,ENSG00000211679,ENSG00000126709,ENSG00000178372,ENSG00000111341,ENSG00000034510,ENSG00000145824,ENSG00000143632,ENSG00000102837,ENSG00000153002,ENSG00000111341,ENSG00000159763,ENSG00000189058,ENSG00000159763,ENSG00000211677,ENSG00000113739,ENSG00000034510,ENSG00000135346,ENSG00000211896,ENSG00000109436,ENSG00000202198,ENSG00000159763,ENSG00000225972,ENSG00000211895,ENSG00000108298,ENSG00000145824,ENSG00000145824,ENSG00000178372,ENSG00000211893,ENSG00000202198,ENSG00000211895,ENSG00000100985,ENSG00000129103,ENSG00000075624,ENSG00000211895,ENSG00000108298,ENSG00000141424,ENSG00000211899,ENSG00000170323,ENSG00000167768
ENSG00000075624,ENSG00000211895,ENSG00000173432,ENSG00000159763,ENSG00000200087,ENSG00000141736,ENSG00000211890,ENSG00000187837,ENSG00000170345,ENSG00000143556,ENSG00000135052,ENSG00000211896,ENSG00000187608,ENSG00000172551,ENSG00000166825,ENSG00000126709,ENSG00000143320,ENSG00000104879,ENSG00000197956,ENSG00000160180,ENSG00000186081,ENSG00000172551,ENSG00000120129,ENSG00000145824,ENSG00000211896,ENSG00000134202,ENSG00000109846,ENSG00000130303,ENSG00000211893,ENSG00000117984,ENSG00000212232,ENSG00000160862,ENSG00000034510,ENSG00000129437,ENSG00000266469,ENSG00000141424,ENSG00000143320,ENSG00000143320,ENSG00000108298,ENSG00000200087,ENSG00000211890,ENSG00000102575,ENSG00000211895,ENSG00000163631,ENSG00000132465,ENSG00000112378,ENSG00000034510,ENSG00000211677,ENSG00000173432,ENSG00000202198
ENSG00000211895,ENSG00000143632,ENSG00000211445,ENSG00000126709,ENSG00000251791,ENSG00000171557,ENSG00000128016,ENSG00000184009,ENSG00000167549,ENSG00000143546,ENSG00000116133,ENSG00000211892,ENSG00000169245,ENSG00000124107,ENSG00000159763,ENSG00000160932,ENSG00000112306,ENSG00000111245,ENSG00000164404,ENSG00000164919,ENSG00000105894,ENSG00000161634,ENSG00000142871,ENSG00000160180,ENSG00000211679,ENSG00000142173,ENSG00000112306,ENSG00000101210,ENSG00000211677,ENSG00000197249,ENSG00000200087,ENSG00000100604,ENSG00000160180,ENSG00000132465,ENSG00000172057,ENSG00000111341,ENSG00000246705,ENSG00000112306,ENSG00000034510,ENSG00000251791,ENSG00000132465,ENSG00000166165,ENSG00000142156,ENSG00000034510,ENSG00000189058,ENSG00000074410,ENSG00000134759,ENSG00000211679,ENSG00000167676,ENSG00000203782
ENSG00000142156,ENSG00000186847,ENSG00000166819,ENSG00000187608,ENSG00000259001,ENSG00000171560,ENSG00000186847,ENSG00000160180,ENSG00000138449,ENSG00000124102,ENSG00000110092,ENSG00000211897,ENSG00000119922,ENSG00000186832,ENSG00000120738,ENSG00000149273,ENSG00000243955,ENSG00000198125,ENSG00000206503,ENSG00000141424,ENSG00000177606,ENSG00000189058,ENSG00000134531,ENSG00000115461,ENSG00000189058,ENSG00000148154,ENSG00000092621,ENSG00000126709,ENSG00000211892,ENSG00000148180,ENSG00000034510,ENSG00000104267,ENSG00000169245,ENSG00000237973,ENSG00000141741,ENSG00000171223,ENSG00000074410,ENSG00000147684,ENSG00000122862,ENSG00000208772,ENSG00000211679,ENSG00000142173,ENSG00000075624,ENSG00000211895,ENSG00000211890,ENSG00000111341,ENSG00000066583,ENSG00000211896,ENSG00000175445,ENSG00000186395
ENSG00000142871,ENSG00000171033,ENSG00000167676,ENSG00000211892,ENSG00000212443,ENSG00000141741,ENSG00000143196,ENSG00000137331,ENSG00000106483,ENSG00000205420,ENSG00000099953,ENSG00000211677,ENSG00000068079,ENSG00000135480,ENSG00000161055,ENSG00000117632,ENSG00000115461,ENSG00000168530,ENSG00000111341,ENSG00000110092,ENSG00000125740,ENSG00000160862,ENSG00000159763,ENSG00000095321,ENSG00000173372,ENSG00000104381,ENSG00000197956,ENSG00000185885,ENSG00000211679,ENSG00000211445,ENSG00000075624,ENSG00000089199,ENSG00000173432,ENSG00000142871,ENSG00000218227,ENSG00000211677,ENSG00000124126,ENSG00000189334,ENSG00000175793,ENSG00000212232,ENSG00000211677,ENSG00000142156,ENSG00000111341,ENSG00000104267,ENSG00000118785,ENSG00000164919,ENSG00000141232,ENSG00000211897,ENSG00000166819,ENSG00000186847
ENSG00000186832,ENSG00000143320,ENSG00000170345,ENSG00000237973,ENSG00000208772,ENSG00000229314,ENSG00000132465,ENSG00000165949,ENSG00000142871,ENSG00000124107,ENSG00000111341,ENSG00000169442,ENSG00000206503,ENSG00000197956,ENSG00000141424,ENSG00000184009,ENSG00000109472,ENSG00000101470,ENSG00000160180,ENSG00000117472,ENSG00000142871,ENSG00000179593,ENSG00000111799,ENSG00000179456,ENSG00000211892,ENSG00000115461,ENSG00000124107,ENSG00000164919,ENSG00000211897,ENSG00000126709,ENSG00000252481,ENSG00000135744,ENSG00000121858,ENSG00000112306,ENSG00000161395,ENSG00000118785,ENSG00000034510,ENSG00000122952,ENSG00000118849,ENSG00000252481,ENSG00000254709,ENSG00000106333,ENSG00000211899,ENSG00000198502,ENSG00000160862,ENSG00000172551,ENSG00000170323,ENSG00000211892,ENSG00000196616,ENSG00000200087
ENSG00000135480,ENSG00000132465,ENSG00000123689,ENSG00000160862,ENSG00000263740,ENSG00000171564,ENSG00000170345,ENSG00000183779,ENSG00000011465,ENSG00000102837,ENSG00000074410,ENSG00000211899,ENSG00000185885,ENSG00000141424,ENSG00000157303,ENSG00000165949,ENSG00000100985,ENSG00000125414,ENSG00000189334,ENSG00000101210,ENSG00000107796,ENSG00000161055,ENSG00000120738,ENSG00000113739,ENSG00000105369,ENSG00000163631,ENSG00000243955,ENSG00000115415,ENSG00000211899,ENSG00000143320,ENSG00000251791,ENSG00000161634,ENSG00000189334,ENSG00000211890,ENSG00000125686,ENSG00000175895,ENSG00000163040,ENSG00000149257,ENSG00000140379,ENSG00000212443,ENSG00000172724,ENSG00000099953,ENSG00000120738,ENSG00000165272,ENSG00000117984,ENSG00000147684,ENSG00000013583,ENSG00000132465,ENSG00000099194,ENSG00000171346
ENSG00000177575,ENSG00000111341,ENSG00000244734,ENSG00000130303,ENSG00000269900,ENSG00000125686,ENSG00000104332,ENSG00000158406,ENSG00000107796,ENSG00000118849,ENSG00000106688,ENSG00000211893,ENSG00000137959,ENSG00000141232,ENSG00000104341,ENSG00000117399,ENSG00000142871,ENSG00000092054,ENSG00000184009,ENSG00000142875,ENSG00000196154,ENSG00000183569,ENSG00000125148,ENSG00000003989,ENSG00000111341,ENSG00000146476,ENSG00000108298,ENSG00000132329,ENSG00000254709,ENSG00000143387,ENSG00000112306,ENSG00000164764,ENSG00000106565,ENSG00000118523,ENSG00000002834,ENSG00000110092,ENSG00000164919,ENSG00000034510,ENSG00000162692,ENSG00000245532,ENSG00000112936,ENSG00000034510,ENSG00000187608,ENSG00000011465,ENSG00000161055,ENSG00000163536,ENSG00000181788,ENSG00000254709,ENSG00000187288,ENSG00000244617
ENSG00000120738,ENSG00000121769,ENSG00000128016,ENSG00000101443,ENSG00000212232,ENSG00000161395,ENSG00000182253,ENSG00000121316,ENSG00000211445,ENSG00000131771,ENSG00000171428,ENSG00000211895,ENSG00000034510,ENSG00000095739,ENSG00000160862,ENSG00000182272,ENSG00000123975,ENSG00000114854,ENSG00000111716,ENSG00000109436,ENSG00000197766,ENSG00000169919,ENSG00000179593,ENSG00000143369,ENSG00000198502,ENSG00000089177,ENSG00000092758,ENSG00000108344,ENSG00000211895,ENSG00000106809,ENSG00000212443,ENSG00000165272,ENSG00000128340,ENSG00000163520,ENSG00000108306,ENSG00000008838,ENSG00000147471,ENSG00000126709,ENSG00000115461,ENSG00000075624,ENSG00000155792,ENSG00000211895,ENSG00000169021,ENSG00000108298,ENSG00000120129,ENSG00000143320,ENSG00000137331,ENSG00000211893,ENSG00000123689,ENSG00000252481
ENSG00000187608,ENSG00000101470,ENSG00000131471,ENSG00000211895,ENSG00000252481,ENSG00000266469,ENSG00000127920,ENSG00000111341,ENSG00000104267,ENSG00000229314,ENSG00000125968,ENSG00000198502,ENSG00000178372,ENSG00000175063,ENSG00000075624,ENSG00000137309,ENSG00000185885,ENSG00000180209,ENSG00000141424,ENSG00000183779,ENSG00000171223,ENSG00000089199,ENSG00000196616,ENSG00000120875,ENSG00000211895,ENSG00000147548,ENSG00000111215,ENSG00000111331,ENSG00000169442,ENSG00000110092,ENSG00000169908,ENSG00000157303,ENSG00000211896,ENSG00000111341,ENSG00000141736,ENSG00000122862,ENSG00000184009,ENSG00000111341,ENSG00000172724,ENSG00000259001,ENSG00000256338,ENSG00000204044,ENSG00000211890,ENSG00000163220,ENSG00000105894,ENSG00000140263,ENSG00000140526,ENSG00000198502,ENSG00000167588,ENSG00000212232
ENSG00000211896,ENSG00000160180,ENSG00000143196,ENSG00000161634,ENSG00000238795,ENSG00000075624,ENSG00000162772,ENSG00000164919,ENSG00000167676,ENSG00000148346,ENSG00000143320,ENSG00000227507,ENSG00000168394,ENSG00000117632,ENSG00000160180,ENSG00000128016,ENSG00000126709,ENSG00000130598,ENSG00000110092,ENSG00000135346,ENSG00000166482,ENSG00000197249,ENSG00000170345,ENSG00000135549,ENSG00000145824,ENSG00000135346,ENSG00000075618,ENSG00000187608,ENSG00000105369,ENSG00000011465,ENSG00000184009,ENSG00000129167,ENSG00000159212,ENSG00000104332,ENSG00000143536,ENSG00000113739,ENSG00000211896,ENSG00000228288,ENSG00000111341,ENSG00000269900,ENSG00000211897,ENSG00000143387,ENSG00000120885,ENSG00000064886,ENSG00000179094,ENSG00000109062,ENSG00000148154,ENSG00000162654,ENSG00000211445,ENSG00000189001
ENSG00000109062,ENSG00000101443,ENSG00000135218,ENSG00000184009,ENSG00000111341,ENSG00000132693,ENSG00000175445,ENSG00000103024,ENSG00000128016,ENSG00000186832,ENSG00000062725,ENSG00000034510,ENSG00000143320,ENSG00000149257,ENSG00000173369,ENSG00000101447,ENSG00000105559,ENSG00000175084,ENSG00000145824,ENSG00000100604,ENSG00000105974,ENSG00000096088,ENSG00000108344,ENSG00000089199,ENSG00000169442,ENSG00000147471,ENSG00000154277,ENSG00000211895,ENSG00000173369,ENSG00000171560,ENSG00000255823,ENSG00000169347,ENSG00000211677,ENSG00000120738,ENSG00000073605,ENSG00000123975,ENSG00000160862,ENSG00000187840,ENSG00000168268,ENSG00000238795,ENSG00000122176,ENSG00000142552,ENSG00000135480,ENSG00000112306,ENSG00000107438,ENSG00000136457,ENSG00000150667,ENSG00000066923,ENSG00000138207,ENSG00000196407
ENSG00000211677,ENSG00000104879,ENSG00000197766,ENSG00000187837,ENSG00000168298,ENSG00000125144,ENSG00000154734,ENSG00000185745,ENSG00000180914,ENSG00000167656,ENSG00000115461,ENSG00000254709,ENSG00000204642,ENSG00000083444,ENSG00000034510,ENSG00000197956,ENSG00000105202,ENSG00000170290,ENSG00000155368,ENSG00000108176,ENSG00000100985,ENSG00000155368,ENSG00000071967,ENSG00000138449,ENSG00000178372,ENSG00000126709,ENSG00000203760,ENSG00000181218,ENSG00000130203,ENSG00000116285,ENSG00000208772,ENSG00000071967,ENSG00000202198,ENSG00000169692,ENSG00000178307,ENSG00000056736,ENSG00000013583,ENSG00000237039,ENSG00000169710,ENSG00000240877,ENSG00000142871,ENSG00000120885,ENSG00000108298,ENSG00000139629,ENSG00000241720,ENSG00000214530,ENSG00000237940,ENSG00000128340,ENSG00000244734,ENSG00000169469
ENSG00000211890,ENSG00000198523,ENSG00000167588,ENSG00000206503,ENSG00000075624,ENSG00000141424,ENSG00000135046,ENSG00000163220,ENSG00000186340,ENSG00000175793,ENSG00000197956,ENSG00000143119,ENSG00000100342,ENSG00000173369,ENSG00000099194,ENSG00000203760,ENSG00000128228,ENSG00000196091,ENSG00000171401,ENSG00000187837,ENSG00000163631,ENSG00000156968,ENSG00000106809,ENSG00000141424,ENSG00000227507,ENSG00000008513,ENSG00000162998,ENSG00000141741,ENSG00000130208,ENSG00000211677,ENSG00000259001,ENSG00000114200,ENSG00000108298,ENSG00000115461,ENSG00000185559,ENSG00000101104,ENSG00000215845,ENSG00000103257,ENSG00000019169,ENSG00000160180,ENSG00000104332,ENSG00000126709,ENSG00000197956,ENSG00000125730,ENSG00000171346,ENSG00000204642,ENSG00000115461,ENSG00000211895,ENSG00000148180,ENSG00000264281
ENSG00000110092,ENSG00000196296,ENSG00000196616,ENSG00000034510,ENSG00000185499,ENSG00000172057,ENSG00000123689,ENSG00000167653,ENSG00000145632,ENSG00000034510,ENSG00000186847,ENSG00000136167,ENSG00000107201,ENSG00000206503,ENSG00000110092,ENSG00000243678,ENSG00000159388,ENSG00000239474,ENSG00000203685,ENSG00000214530,ENSG00000120738,ENSG00000100031,ENSG00000161634,ENSG00000075624,ENSG00000172724,ENSG00000111052,ENSG00000104783,ENSG00000107201,ENSG00000124107,ENSG00000148344,ENSG00000197956,ENSG00000122176,ENSG00000132693,ENSG00000112759,ENSG00000008838,ENSG00000128283,ENSG00000140479,ENSG00000202198,ENSG00000132465,ENSG00000186340,ENSG00000011465,ENSG00000125995,ENSG00000177606,ENSG00000013583,ENSG00000179593,ENSG00000099194,ENSG00000146476,ENSG00000105369,ENSG00000143196,ENSG00000251791
ENSG00000186081,ENSG00000183386,ENSG00000138207,ENSG00000143578,ENSG00000201302,ENSG00000211892,ENSG00000189129,ENSG00000153002,ENSG00000107562,ENSG00000169469,ENSG00000189334,ENSG00000143320,ENSG00000162407,ENSG00000105202,ENSG00000108179,ENSG00000104738,ENSG00000171564,ENSG00000177791,ENSG00000071575,ENSG00000187244,ENSG00000041982,ENSG00000115255,ENSG00000141424,ENSG00000196405,ENSG00000187608,ENSG00000129691,ENSG00000158887,ENSG00000084444,ENSG00000135916,ENSG00000171564,ENSG00000254911,ENSG00000104368,ENSG00000172724,ENSG00000112378,ENSG00000168389,ENSG00000125730,ENSG00000233622,ENSG00000132432,ENSG00000135094,ENSG00000184009,ENSG00000107562,ENSG00000112306,ENSG00000034510,ENSG00000186081,ENSG00000132481,ENSG00000147475,ENSG00000147471,ENSG00000105374,ENSG00000197766,ENSG00000185567
ENSG00000115963,ENSG00000111245,ENSG00000163815,ENSG00000198502,ENSG00000111799,ENSG00000108344,ENSG00000123358,ENSG00000141736,ENSG00000120129,ENSG00000182853,ENSG00000146476,ENSG00000105369,ENSG00000130203,ENSG00000206341,ENSG00000128016,ENSG00000163923,ENSG00000164919,ENSG00000077522,ENSG00000151726,ENSG00000162482,ENSG00000187288,ENSG00000107438,ENSG00000101210,ENSG00000114200,ENSG00000113739,ENSG00000013583,ENSG00000249992,ENSG00000197457,ENSG00000099958,ENSG00000126803,ENSG00000238795,ENSG00000172551,ENSG00000211893,ENSG00000119900,ENSG00000174721,ENSG00000104879,ENSG00000140443,ENSG00000114631,ENSG00000186340,ENSG00000212607,ENSG00000105369,ENSG00000166825,ENSG00000129437,ENSG00000115461,ENSG00000133392,ENSG00000184678,ENSG00000180530,ENSG00000100342,ENSG00000120738,ENSG00000115419
ENSG00000189058,ENSG00000173991,ENSG00000125740,ENSG00000202198,ENSG00000240877,ENSG00000108349,ENSG00000142871,ENSG00000143387,ENSG00000174807,ENSG00000160213,ENSG00000184009,ENSG00000105374,ENSG00000211893,ENSG00000134202,ENSG00000172551,ENSG00000112306,ENSG00000075624,ENSG00000196296,ENSG00000075624,ENSG00000184678,ENSG00000128016,ENSG00000134201,ENSG00000108298,ENSG00000104368,ENSG00000108298,ENSG00000169490,ENSG00000163017,ENSG00000233622,ENSG00000225972,ENSG00000197956,ENSG00000269900,ENSG00000112796,ENSG00000185885,ENSG00000122862,ENSG00000143753,ENSG00000164879,ENSG00000168461,ENSG00000142173,ENSG00000077152,ENSG00000254911,ENSG00000164949,ENSG00000196843,ENSG00000160932,ENSG00000145386,ENSG00000034510,ENSG00000168394,ENSG00000144218,ENSG00000173372,ENSG00000135218,ENSG00000092969
ENSG00000135916,ENSG00000168530,ENSG00000105974,ENSG00000211896,ENSG00000225630,ENSG00000184009,ENSG00000163017,ENSG00000189058,ENSG00000211890,ENSG00000241794,ENSG00000183779,ENSG00000211772,ENSG00000206341,ENSG00000143320,ENSG00000170312,ENSG00000168061,ENSG00000012660,ENSG00000129170,ENSG00000100979,ENSG00000105290,ENSG00000166250,ENSG00000158104,ENSG00000012660,ENSG00000075886,ENSG00000134352,ENSG00000214530,ENSG00000196154,ENSG00000117472,ENSG00000159189,ENSG00000205362,ENSG00000159388,ENSG00000150687,ENSG00000117228,ENSG00000170345,ENSG00000225630,ENSG00000149262,ENSG00000144218,ENSG00000160180,ENSG00000120708,ENSG00000145824,ENSG00000112306,ENSG00000214530,ENSG00000100985,ENSG00000112685,ENSG00000211677,ENSG00000142875,ENSG00000153982,ENSG00000091490,ENSG00000105974,ENSG00000184260
ENSG00000138449,ENSG00000114854,ENSG00000120738,ENSG00000185885,ENSG00000118523,ENSG00000131771,ENSG00000165507,ENSG00000162551,ENSG00000120738,ENSG00000140519,ENSG00000138449,ENSG00000090382,ENSG00000135114,ENSG00000143013,ENSG00000145675,ENSG00000137166,ENSG00000162576,ENSG00000173991,ENSG00000237973,ENSG00000180573,ENSG00000211890,ENSG00000067064,ENSG00000185499,ENSG00000243649,ENSG00000146731,ENSG00000111666,ENSG00000187840,ENSG00000155093,ENSG00000173372,ENSG00000113739,ENSG00000173334,ENSG00000112996,ENSG00000126709,ENSG00000021300,ENSG00000143333,ENSG00000211896,ENSG00000169710,ENSG00000006282,ENSG00000075624,ENSG00000126709,ENSG00000177606,ENSG00000134013,ENSG00000125730,ENSG00000182154,ENSG00000164022,ENSG00000129691,ENSG00000164919,ENSG00000159189,ENSG00000120129,ENSG00000172867
ENSG00000136770,ENSG00000143387,ENSG00000175445,ENSG00000141424,ENSG00000212607,ENSG00000131748,ENSG00000076706,ENSG00000175895,ENSG00000123689,ENSG00000178372,ENSG00000013583,ENSG00000231389,ENSG00000115828,ENSG00000168268,ENSG00000071967,ENSG00000074527,ENSG00000179862,ENSG00000108515,ENSG00000203876,ENSG00000109472,ENSG00000170323,ENSG00000100604,ENSG00000121691,ENSG00000197249,ENSG00000185499,ENSG00000155792,ENSG00000163975,ENSG00000186891,ENSG00000051523,ENSG00000165949,ENSG00000146648,ENSG00000139970,ENSG00000090382,ENSG00000163131,ENSG00000108344,ENSG00000002834,ENSG00000272335,ENSG00000114115,ENSG00000152661,ENSG00000212664,ENSG00000019102,ENSG00000141424,ENSG00000111716,ENSG00000213281,ENSG00000011465,ENSG00000146476,ENSG00000168350,ENSG00000139193,ENSG00000004799,ENSG00000186832
